Rank,Release Group,Worldwide,Domestic,Foreign,filename,year,Domestic %,Foreign %
1,Avengers: Endgame,2797501328,858373000,1939128328,2019.csv,2019,0.30683560054417247,0.6931643994558275
2,Avatar,2743577587,749766139,1993811448,2009.csv,2009,0.27328045780540194,0.726719542194598
3,Star Wars: Episode VII - The Force Awakens,2068223624,936662225,1131561399,2015.csv,2015,0.4528824707980417,0.5471175292019583
4,Avengers: Infinity War,2048359754,678815482,1369544272,2018.csv,2018,0.3313946589091205,0.6686053410908794
5,Spider-Man: No Way Home,1901232550,804793477,1096439073,2021.csv,2021,0.4233009144515225,0.5766990855484775
6,Jurassic World,1670400637,652270625,1018130012,2015.csv,2015,0.39048753368022093,0.6095124663197791
7,The Lion King,1656943394,543638043,1113305351,2019.csv,2019,0.32809693135479556,0.6719030686452044
8,The Avengers,1518812988,623357910,895455078,2012.csv,2012,0.41042440045291473,0.5895755995470853
9,Furious 7,1515047671,353007020,1162040651,2015.csv,2015,0.23300060239490641,0.7669993976050936
10,Frozen II,1450026933,477373578,972653355,2019.csv,2019,0.329217042205105,0.6707829577948949
11,Avengers: Age of Ultron,1402805868,459005868,943800000,2015.csv,2015,0.3272055517235689,0.6727944482764311
12,Black Panther,1346913161,700059566,646853595,2018.csv,2018,0.5197510769589992,0.4802489230410007
13,Harry Potter and the Deathly Hallows: Part 2,1341511219,381011219,960500000,2011.csv,2011,0.2840164238686102,0.7159835761313897
14,Star Wars: Episode VIII - The Last Jedi,1332539889,620181382,712358507,2017.csv,2017,0.465412995978239,0.5345870040217611
15,Jurassic World: Fallen Kingdom,1308467944,417719760,890748184,2018.csv,2018,0.3192434036427567,0.6807565963572433
16,Frozen,1280802282,400738009,880064273,2013.csv,2013,0.31288046143565507,0.6871195385643449
17,Beauty and the Beast,1263521126,504014165,759506961,2017.csv,2017,0.3988965080430321,0.6011034919569679
18,Incredibles 2,1242805359,608581744,634223615,2018.csv,2018,0.48968387494698595,0.510316125053014
19,The Fate of the Furious,1236005118,226008385,1009996733,2017.csv,2017,0.1828539232634472,0.8171460767365528
20,Iron Man 3,1214811252,409013994,805797258,2013.csv,2013,0.33668933616363966,0.6633106638363603
21,Top Gun: Maverick,1189821383,601921383,587900000,2022.csv,2022,0.5058922218075484,0.4941077781924516
22,Minions,1159398397,336045770,823352627,2015.csv,2015,0.28984494964762314,0.7101550503523768
23,Captain America: Civil War,1153296293,408084349,745211944,2016.csv,2016,0.35384172434862754,0.6461582756513724
24,Aquaman,1148461807,335061807,813400000,2018.csv,2018,0.2917483236776023,0.7082516763223977
25,The Lord of the Rings: The Return of the King,1140682011,377027325,763654686,2003.csv,2003,0.3305279835784138,0.6694720164215863
26,Spider-Man: Far from Home,1131927996,390532085,741395911,2019.csv,2019,0.345014953583673,0.654985046416327
27,Captain Marvel,1128274794,426829839,701444955,2019.csv,2019,0.3783030882811692,0.6216969117188308
28,Transformers: Dark of the Moon,1123794079,352390543,771403536,2011.csv,2011,0.3135721655639725,0.6864278344360275
29,Skyfall,1108561013,304360277,804200736,2012.csv,2012,0.2745543758356943,0.7254456241643057
30,Transformers: Age of Extinction,1104054072,245439076,858614996,2014.csv,2014,0.22230711540729683,0.7776928845927031
31,The Dark Knight Rises,1081041287,448139099,632902188,2012.csv,2012,0.4145439257399981,0.5854560742600019
32,Joker,1074251311,335451311,738800000,2019.csv,2019,0.3122652097931673,0.6877347902068327
33,Star Wars: Episode IX - The Rise of Skywalker,1074144248,515202542,558941706,2019.csv,2019,0.4796399952420543,0.5203600047579457
34,Toy Story 4,1073394593,434038008,639356585,2019.csv,2019,0.4043601587249657,0.5956398412750342
35,Toy Story 3,1066969703,415004880,651964823,2010.csv,2010,0.3889565737744289,0.6110434262255711
36,Pirates of the Caribbean: Dead Man's Chest,1066179725,423315812,642863913,2006.csv,2006,0.3970398255322291,0.602960174467771
37,Rogue One: A Star Wars Story,1056057273,532177324,523879949,2016.csv,2016,0.5039284682810948,0.49607153171890517
38,Aladdin,1050693953,355559216,695134737,2019.csv,2019,0.3384041708670612,0.6615958291329388
39,Pirates of the Caribbean: On Stranger Tides,1045713802,241071802,804642000,2011.csv,2011,0.23053325062644625,0.7694667493735537
40,Despicable Me 3,1034799409,264624300,770175109,2017.csv,2017,0.2557252136969475,0.7442747863030524
41,Finding Dory,1028570889,486295561,542275328,2016.csv,2016,0.47278759898871686,0.5272124010112832
42,Alice in Wonderland,1025467110,334191110,691276000,2010.csv,2010,0.32589159295416115,0.6741084070458389
43,Zootopia,1023784195,341268248,682515947,2016.csv,2016,0.3333400238709487,0.6666599761290513
44,The Hobbit: An Unexpected Journey,1017003568,303003568,714000000,2012.csv,2012,0.29793756633113405,0.7020624336688659
45,The Dark Knight,1003045358,533345358,469700000,2008.csv,2008,0.5317260617839378,0.4682739382160622
46,Harry Potter and the Deathly Hallows: Part 1,976536918,295983305,680553613,2010.csv,2010,0.30309484418283916,0.6969051558171608
47,Harry Potter and the Sorcerer's Stone,974755371,317575550,657179821,2001.csv,2001,0.32580025660612644,0.6741997433938736
48,Despicable Me 2,970766005,368065385,602700620,2013.csv,2013,0.3791494377679614,0.6208505622320386
49,The Jungle Book,966550600,364001123,602549477,2016.csv,2016,0.3765981036067848,0.6234018963932152
50,Jumanji: Welcome to the Jungle,962077546,404515480,557562066,2017.csv,2017,0.42046036900231326,0.5795396309976868
51,Pirates of the Caribbean: At World's End,960996492,309420425,651576067,2007.csv,2007,0.32197872476729084,0.6780212752327092
52,The Hobbit: The Desolation of Smaug,958366855,258366855,700000000,2013.csv,2013,0.2695907664711547,0.7304092335288452
53,The Hobbit: The Battle of the Five Armies,956019788,255119788,700900000,2014.csv,2014,0.26685617934092387,0.7331438206590761
54,Doctor Strange in the Multiverse of Madness,954006455,411085499,542920956,2022.csv,2022,0.4309043160509852,0.5690956839490148
55,Harry Potter and the Order of the Phoenix,941676843,292004738,649672105,2007.csv,2007,0.31009017602018274,0.6899098239798173
56,The Lord of the Rings: The Two Towers,936689735,339789881,596899854,2002.csv,2002,0.36275606351125433,0.6372439364887457
57,Harry Potter and the Half-Blood Prince,933959197,301959197,632000000,2009.csv,2009,0.32331090905248616,0.6766890909475138
58,Shrek 2,928760770,441226247,487534523,2004.csv,2004,0.47506985787093486,0.5249301421290652
59,Star Wars: Episode I - The Phantom Menace,924305084,431088295,493216789,1999.csv,1999,0.4663917817420552,0.5336082182579448
60,Bohemian Rhapsody,903655259,216428042,687227217,2018.csv,2018,0.23950288546929155,0.7604971145307085
61,The Battle at Lake Changjin,902540935,342411,902198524,2021.csv,2021,0.00037938556216289516,0.9996206144378371
62,Harry Potter and the Goblet of Fire,895921036,290013036,605908000,2005.csv,2005,0.3237037912345659,0.6762962087654341
63,Spider-Man 3,894983373,336530303,558453070,2007.csv,2007,0.3760184972732449,0.6239815027267551
64,Ice Age: Dawn of the Dinosaurs,886686817,196573705,690113112,2009.csv,2009,0.22169462907442775,0.7783053709255723
65,The Lord of the Rings: The Fellowship of the Ring,880839846,313364114,567475732,2001.csv,2001,0.35575606101724877,0.6442439389827512
66,Spectre,880674609,200074609,680600000,2015.csv,2015,0.22718335121207064,0.7728166487879293
67,Spider-Man: Homecoming,880166924,334201140,545965784,2017.csv,2017,0.37970199843592395,0.620298001564076
68,Harry Potter and the Chamber of Secrets,878979634,261988482,616991152,2002.csv,2002,0.2980597864455185,0.7019402135544816
69,Jurassic World Dominion,878857710,352844710,526013000,2022.csv,2022,0.4014810429324219,0.5985189570675781
70,Ice Age: Continental Drift,877244782,161321843,715922939,2012.csv,2012,0.18389604168657225,0.8161039583134277
71,The Secret Life of Pets,875457937,368384330,507073607,2016.csv,2016,0.42079043941548044,0.5792095605845196
72,Batman v Superman: Dawn of Justice,873634919,330360194,543274725,2016.csv,2016,0.3781444477724682,0.6218555522275317
73,Finding Nemo,871014978,339714978,531300000,2003.csv,2003,0.3900219704373442,0.6099780295626558
74,Wolf Warrior 2,870325439,2721100,867604339,2017.csv,2017,0.003126531614572282,0.9968734683854277
75,Star Wars: Episode III - Revenge of the Sith,868352530,380270577,488081953,2005.csv,2005,0.437921885250913,0.562078114749087
76,The Hunger Games: Catching Fire,865011746,424668047,440343699,2013.csv,2013,0.490939052520103,0.5090609474798969
77,Guardians of the Galaxy Vol. 2,863756051,389813101,473942950,2017.csv,2017,0.4512999944240043,0.5487000055759956
78,Inside Out,857611174,356461711,501149463,2015.csv,2015,0.4156449004009829,0.5843550995990171
79,Venom,856085151,213515506,642569645,2018.csv,2018,0.24940919224050412,0.7505908077594958
80,Thor: Ragnarok,853977126,315058289,538918837,2017.csv,2017,0.36893059475225337,0.6310694052477467
81,Transformers: Revenge of the Fallen,836303693,402111870,434191823,2009.csv,2009,0.4808203925986968,0.5191796074013032
82,The Twilight Saga: Breaking Dawn - Part 2,829746820,292324737,537422083,2012.csv,2012,0.35230594436023266,0.6476940556397673
83,Inception,826137188,292576195,533560993,2010.csv,2010,0.3541496488111125,0.6458503511888876
84,"Hi, Mom",822009764,0,822009764,2021.csv,2021,0.0,1.0
85,Wonder Woman,821847012,412563408,409283604,2017.csv,2017,0.501995385973369,0.49800461402663104
86,Spider-Man,821708551,403706375,418002176,2002.csv,2002,0.4913011730359856,0.5086988269640144
87,Fantastic Beasts and Where to Find Them,814037575,234037575,580000000,2016.csv,2016,0.287502177034027,0.7124978229659731
88,Shrek the Third,813367380,322719944,490647436,2007.csv,2007,0.3967702073323865,0.6032297926676135
89,Coco,807816196,210460015,597356181,2017.csv,2017,0.2605295809147159,0.7394704190852841
90,Jumanji: The Next Level,800059707,320314960,479744747,2019.csv,2019,0.4003638193467978,0.5996361806532021
91,Harry Potter and the Prisoner of Azkaban,795634069,249541069,546093000,2004.csv,2004,0.31363798852107727,0.6863620114789227
92,Pirates of the Caribbean: Dead Men Tell No Tales,794861794,172558876,622302918,2017.csv,2017,0.21709293024593404,0.782907069754066
93,Mission: Impossible - Fallout,791115104,220159104,570956000,2018.csv,2018,0.27828959766643513,0.7217104023335649
94,Indiana Jones and the Kingdom of the Crystal Skull,790653942,317101119,473552823,2008.csv,2008,0.40106183268735285,0.5989381673126472
95,Fast & Furious 6,788679850,238679850,550000000,2013.csv,2013,0.30263211365169274,0.6973678863483073
96,Spider-Man 2,788618317,373585825,415032492,2004.csv,2004,0.4737219729072055,0.5262780270927945
97,Deadpool,782612155,363070709,419541446,2016.csv,2016,0.463921633059737,0.536078366940263
98,No Time to Die,774153007,160891007,613262000,2021.csv,2021,0.20782843384344046,0.7921715661565596
99,Guardians of the Galaxy,772776600,333176600,439600000,2014.csv,2014,0.4311421955581988,0.5688578044418011
100,The Batman,770836163,369345583,401490580,2022.csv,2022,0.4791492676764829,0.5208507323235171
101,2012,769679473,166112167,603567306,2009.csv,2009,0.21581992612137652,0.7841800738786235
102,The Da Vinci Code,760006945,217536138,542470807,2006.csv,2006,0.28622914491919543,0.7137708550808045
103,Fast & Furious Presents: Hobbs & Shaw,759056935,173956935,585100000,2019.csv,2019,0.22917508157671992,0.77082491842328
104,Maleficent,758410378,241410378,517000000,2014.csv,2014,0.31831101604466705,0.681688983955333
105,The Amazing Spider-Man,757930663,262030663,495900000,2012.csv,2012,0.34571851462354675,0.6542814853764533
106,The Hunger Games: Mockingjay - Part 1,755356711,337135885,418220826,2014.csv,2014,0.44632672231596815,0.5536732776840319
107,Shrek Forever After,752600867,238736787,513864080,2010.csv,2010,0.31721566831519477,0.6827843316848052
108,Madagascar 3: Europe's Most Wanted,746921274,216391482,530529792,2012.csv,2012,0.2897112313338661,0.7102887686661339
109,Suicide Squad,746846894,325100054,421746840,2016.csv,2016,0.43529678788488074,0.5647032121151193
110,X-Men: Days of Future Past,746045700,233921534,512124166,2014.csv,2014,0.3135485319465014,0.6864514680534985
111,"The Chronicles of Narnia: The Lion, the Witch and the Wardrobe",745013115,291710957,453302158,2005.csv,2005,0.39155143866158654,0.6084485613384135
112,Monsters University,743559607,268492764,475066843,2013.csv,2013,0.3610911102114238,0.6389088897885762
113,The Matrix Reloaded,739412035,281576461,457835574,2003.csv,2003,0.3808113036731949,0.6191886963268052
114,Up,735099082,293004164,442094918,2009.csv,2009,0.3985913888000203,0.6014086111999797
115,Deadpool 2,734546611,318491426,416055185,2018.csv,2018,0.43358912998919275,0.5664108700108073
116,F9: The Fast Saga,726229501,173005945,553223556,2021.csv,2021,0.23822489276705933,0.7617751072329407
117,Ne Zha,726063471,3695533,722367938,2019.csv,2019,0.005089820859476899,0.9949101791405232
118,Gravity,723192705,274092705,449100000,2013.csv,2013,0.37900369169238235,0.6209963083076177
119,Captain America: The Winter Soldier,714421503,259766572,454654931,2014.csv,2014,0.3636040781376089,0.6363959218623911
120,The Twilight Saga: Breaking Dawn - Part 1,712205856,281287133,430918723,2011.csv,2011,0.394952008089077,0.6050479919109231
121,Dawn of the Planet of the Apes,710644566,208545589,502098977,2014.csv,2014,0.29345976734028806,0.7065402326597119
122,The Twilight Saga: New Moon,709827462,296623634,413203828,2009.csv,2009,0.4178813160655089,0.5821186839344911
123,Transformers,709709780,319246193,390463587,2007.csv,2007,0.44982639664342794,0.5501736033565721
124,The Amazing Spider-Man 2,708982323,202853933,506128390,2014.csv,2014,0.28611987410580336,0.7138801258941967
125,It,700381748,327481748,372900000,2017.csv,2017,0.4675760739555994,0.5324239260444006
126,The Wandering Earth,699856699,5971413,693885286,2019.csv,2019,0.008532336703402763,0.9914676632965972
127,The Twilight Saga: Eclipse,698491347,300531751,397959596,2010.csv,2010,0.4302583736946422,0.5697416263053579
128,Mission: Impossible - Ghost Protocol,694713380,209397903,485315477,2011.csv,2011,0.3014162516921727,0.6985837483078273
129,The Hunger Games,694394724,408010692,286384032,2012.csv,2012,0.5875774655223331,0.4124225344776669
130,Detective Chinatown 3,686257563,0,686257563,2021.csv,2021,0.0,1.0
131,Mission: Impossible - Rogue Nation,682714267,195042377,487671890,2015.csv,2015,0.2856866868434727,0.7143133131565274
132,Interstellar,677896797,188020017,489876780,2014.csv,2014,0.2773578778245798,0.7226421221754201
133,Doctor Strange,677718395,232641920,445076475,2016.csv,2016,0.3432722524817996,0.6567277475182004
134,The Sixth Sense,672806292,293506292,379300000,1999.csv,1999,0.43624189531212054,0.5637581046878795
135,Man of Steel,668045518,291045518,377000000,2013.csv,2013,0.4356671965577052,0.5643328034422948
136,Kung Fu Panda 2,665692281,165249063,500443218,2011.csv,2011,0.24823641150196843,0.7517635884980316
137,Ice Age: The Meltdown,660998756,195330621,465668135,2006.csv,2006,0.29550830349822926,0.7044916965017707
138,Justice League,657924295,229024295,428900000,2017.csv,2017,0.3481012887660578,0.6518987112339422
139,Big Hero 6,657827828,222527828,435300000,2014.csv,2014,0.33827670178769026,0.6617232982123098
140,Fantastic Beasts: The Crimes of Grindelwald,654855901,159555901,495300000,2018.csv,2018,0.24365039813545178,0.7563496018645482
141,Pirates of the Caribbean: The Curse of the Black Pearl,654264015,305413918,348850097,2003.csv,2003,0.4668053125312111,0.5331946874687888
142,The Hunger Games: Mockingjay - Part 2,653428261,281723902,371704359,2015.csv,2015,0.43114740946290353,0.5688525905370965
143,Star Wars: Episode II - Attack of the Clones,645256452,302191252,343065200,2002.csv,2002,0.4683273620331037,0.5316726379668963
144,Thor: The Dark World,644783140,206362140,438421000,2013.csv,2013,0.32004890822672566,0.6799510917732744
145,Moana,643331111,248757044,394574067,2016.csv,2016,0.38667031602642327,0.6133296839735767
146,Sing,634151679,270395425,363756254,2016.csv,2016,0.42638919670825315,0.5736108032917469
147,Kung Fu Panda,631744560,215434591,416309969,2008.csv,2008,0.3410153480387706,0.6589846519612294
148,The Incredibles,631442092,261441092,370001000,2004.csv,2004,0.4140381126192012,0.5859618873807988
149,The Martian,630161890,228433663,401728227,2015.csv,2015,0.36249996488997455,0.6375000351100255
150,Hancock,629443428,227946274,401497154,2008.csv,2008,0.3621394137425167,0.6378605862574833
151,Water Gate Bridge,626571280,117294,626453986,2022.csv,2022,0.00018719977079064332,0.9998128002292094
152,Fast Five,626137675,209837675,416300000,2011.csv,2011,0.33513024911014977,0.6648697508898502
153,Men in Black 3,624026776,179020854,445005922,2012.csv,2012,0.2868800841328001,0.7131199158671999
154,Iron Man 2,623933331,312433331,311500000,2010.csv,2010,0.5007479412892594,0.4992520587107407
155,Ratatouille,623726085,206445654,417280431,2007.csv,2007,0.3309876866862158,0.6690123133137842
156,Ant-Man and the Wasp,622674139,216648740,406025399,2018.csv,2018,0.3479327732285988,0.6520672267714012
157,How to Train Your Dragon 2,621537519,177002924,444534595,2014.csv,2014,0.2847823640393944,0.7152176359606056
158,Logan,619021436,226277068,392744368,2017.csv,2017,0.36553995522701094,0.6344600447729891
159,The Passion of the Christ,611486736,370274604,241212132,2004.csv,2004,0.6055317019991747,0.39446829800082533
160,Mamma Mia!,609841637,144130063,465711574,2008.csv,2008,0.23634014841790804,0.7636598515820919
161,Life of Pi,609016565,124987023,484029542,2012.csv,2012,0.20522762463776334,0.7947723753622367
162,Casino Royale,605999592,167445960,438553632,2006.csv,2006,0.27631365137948805,0.723686348620512
163,Transformers: The Last Knight,605425157,130168683,475256474,2017.csv,2017,0.21500375644284633,0.7849962435571537
164,Madagascar: Escape 2 Africa,603900354,180010950,423889404,2008.csv,2008,0.298080550553875,0.701919449446125
165,War of the Worlds,603873119,234280354,369592765,2005.csv,2005,0.38796287933459084,0.6120371206654092
166,Tangled,592461732,200821936,391639796,2010.csv,2010,0.33896186901738995,0.66103813098261
167,Quantum of Solace,589580482,168368427,421212055,2008.csv,2008,0.2855732714028345,0.7144267285971655
168,The Croods,587204668,187168425,400036243,2013.csv,2013,0.3187447838885368,0.6812552161114632
169,The Hangover Part II,586764305,254464305,332300000,2011.csv,2011,0.43367379854505633,0.5663262014549436
170,I Am Legend,585410052,256393010,329017042,2007.csv,2007,0.4379716561477834,0.5620283438522166
171,Iron Man,585366247,318604126,266762121,2008.csv,2008,0.5442816828487209,0.45571831715127914
172,Ready Player One,582890172,137690172,445200000,2018.csv,2018,0.23621975221774713,0.7637802477822528
173,Operation Red Sea,579330426,1543547,577786879,2018.csv,2018,0.0026643637736368433,0.9973356362263631
174,Night at the Museum,574480841,250863268,323617573,2006.csv,2006,0.43667821465259277,0.5633217853474073
175,Fifty Shades of Grey,569651467,166167230,403484237,2015.csv,2015,0.2916998193212763,0.7083001806787237
176,Kong: Skull Island,566652812,168052812,398600000,2017.csv,2017,0.29657103686975084,0.7034289631302492
177,The Smurfs,563749323,142614158,421135165,2011.csv,2011,0.2529744199799243,0.7470255800200757
178,Cars 2,559852396,191452396,368400000,2011.csv,2011,0.3419694143811434,0.6580305856188566
179,King Kong,556906378,218080025,338826353,2005.csv,2005,0.3915918969776999,0.6084081030223001
180,Puss in Boots,554987477,149260504,405726973,2011.csv,2011,0.26894391348581725,0.7310560865141827
181,The Mermaid,553810228,3232685,550577543,2016.csv,2016,0.005837170995693492,0.9941628290043065
182,The Day After Tomorrow,552639571,186740799,365898772,2004.csv,2004,0.3379070352528194,0.6620929647471806
183,Ted,549368315,218815487,330552828,2012.csv,2012,0.398303799155217,0.6016962008447829
184,American Sniper,547426372,350126372,197300000,2014.csv,2014,0.639586234621521,0.3604137653784791
185,Mission: Impossible II,546388108,215409889,330978219,2000.csv,2000,0.3942433699527004,0.6057566300472996
186,Detective Chinatown 2,544185156,1983984,542201172,2018.csv,2018,0.0036457885301083076,0.9963542114698917
187,X-Men: Apocalypse,543934105,155442489,388491616,2016.csv,2016,0.285774485495812,0.7142255145041879
188,Sherlock Holmes: A Game of Shadows,543848418,186848418,357000000,2011.csv,2011,0.3435670893134785,0.6564329106865214
189,Despicable Me,543113985,251513985,291600000,2010.csv,2010,0.4630961307321151,0.5369038692678849
190,Cinderella,542351353,201151353,341200000,2015.csv,2015,0.3708875286976559,0.6291124713023442
191,Madagascar,542063846,193595521,348468325,2005.csv,2005,0.35714523746341126,0.6428547625365887
192,World War Z,540007876,202359711,337648165,2013.csv,2013,0.37473473997997764,0.6252652600200224
193,Brave,538983207,237283207,301700000,2012.csv,2012,0.4402423005360907,0.5597576994639093
194,The Simpsons Movie,536414270,183135014,353279256,2007.csv,2007,0.34140593239624295,0.658594067603757
195,The Revenant,532950503,183637894,349312609,2015.csv,2015,0.34456838480552104,0.6554316151944789
196,The Meg,530243742,145443742,384800000,2018.csv,2018,0.2742960085703378,0.7257039914296621
197,Ralph Breaks the Internet,529323962,201091711,328232251,2018.csv,2018,0.3799029052835511,0.6200970947164489
198,"Monsters, Inc.",528773250,255873250,272900000,2001.csv,2001,0.48389976232723575,0.5161002376727643
199,Hotel Transylvania 3: Summer Vacation,528583774,167510016,361073758,2018.csv,2018,0.31690343941583043,0.6830965605841696
200,The Boss Baby,527965936,175003033,352962903,2017.csv,2017,0.331466522870521,0.6685334771294791
201,Dunkirk,525245546,188045546,337200000,2017.csv,2017,0.3580145465907482,0.6419854534092517
202,Godzilla,524976069,200676069,324300000,2014.csv,2014,0.38225755582013016,0.6177424441798699
203,Sherlock Holmes,524028679,209028679,315000000,2009.csv,2009,0.39888786125005193,0.6011121387499481
204,Meet the Fockers,522657936,279261160,243396776,2004.csv,2004,0.5343096139269183,0.46569038607308166
205,How to Train Your Dragon: The Hidden World,521799505,160799505,361000000,2019.csv,2019,0.3081633912243746,0.6918366087756255
206,WALL·E,521311860,223808164,297503696,2008.csv,2008,0.4293172305728859,0.5706827694271142
207,Kung Fu Panda 3,521170825,143528619,377642206,2016.csv,2016,0.2753964959569638,0.7246035040430362
208,Ant-Man,519311965,180202163,339109802,2015.csv,2015,0.3470017545234106,0.6529982454765894
209,The Grinch,511595957,270620950,240975007,2018.csv,2018,0.5289739809261237,0.4710260190738763
210,Venom: Let There Be Carnage,506863592,213550366,293313226,2021.csv,2021,0.42131723282267236,0.5786827671773277
211,Rio 2,498781117,131538435,367242682,2014.csv,2014,0.2637197570572825,0.7362802429427175
212,Troy,497409852,133378256,364031596,2004.csv,2004,0.268145585504004,0.731854414495996
213,How to Train Your Dragon,494878759,217581231,277297528,2010.csv,2010,0.4396657303289107,0.5603342696710892
214,Oz the Great and Powerful,493311825,234911825,258400000,2013.csv,2013,0.47619337930932426,0.5238066206906757
215,Clash of the Titans,493214993,163214888,330000105,2010.csv,2010,0.33092037005452507,0.6690796299454749
216,Maleficent: Mistress of Evil,491730089,113929605,377800484,2019.csv,2019,0.23169134358178353,0.7683086564182164
217,War for the Planet of the Apes,490719763,146880162,343839601,2017.csv,2017,0.2993157665019495,0.7006842334980505
218,Mr. & Mrs. Smith,487287646,186336279,300951367,2005.csv,2005,0.38239483502112015,0.6176051649788799
219,Toy Story 2,487059677,245852179,241207498,1999.csv,1999,0.5047680820434659,0.4952319179565341
220,Angels & Demons,485930816,133375846,352554970,2009.csv,2009,0.2744749697043293,0.7255250302956707
221,Teenage Mutant Ninja Turtles,485004754,191204754,293800000,2014.csv,2014,0.39423274189184543,0.6057672581081546
222,Bruce Almighty,484592874,242829261,241763613,2003.csv,2003,0.5010995291688916,0.49890047083110844
223,Shrek,484409218,267665011,216744207,2001.csv,2001,0.5525596975737155,0.4474403024262845
224,Rio,483866518,143619809,340246709,2011.csv,2011,0.29681700150205476,0.7031829984979453
225,Rise of the Planet of the Apes,481800873,176760185,305040688,2011.csv,2011,0.3668739408863628,0.6331260591136372
226,Charlie and the Chocolate Factory,474968763,206459076,268509687,2005.csv,2005,0.43467927173981336,0.5653207282601866
227,Hotel Transylvania 2,474800000,169700110,305099890,2015.csv,2015,0.3574138795282224,0.6425861204717775
228,San Andreas,473990832,155190832,318800000,2015.csv,2015,0.32741315131597315,0.6725868486840269
229,It Chapter Two,473093228,211593228,261500000,2019.csv,2019,0.44725482310222375,0.5527451768977762
230,Wreck-It Ralph,471222889,189422889,281800000,2012.csv,2012,0.40198151113156133,0.5980184888684387
231,Godzilla vs. Kong,470067014,100916094,369150920,2021.csv,2021,0.21468448326391182,0.7853155167360882
232,The Hangover,468812793,277322503,191490290,2009.csv,2009,0.5915420977003928,0.40845790229960727
233,The Lego Movie,468060692,257760692,210300000,2014.csv,2014,0.5506992926464331,0.44930070735356686
234,Bumblebee,467989645,127195589,340794056,2018.csv,2018,0.2717914602576303,0.7282085397423698
235,Star Trek Into Darkness,467365246,228778661,238586585,2013.csv,2013,0.4895072172311246,0.5104927827688753
236,The Matrix,463517383,171479930,292037453,1999.csv,1999,0.3699536118583928,0.6300463881416072
237,Cars,461983149,244082982,217900167,2006.csv,2006,0.5283374134496841,0.47166258655031595
238,The Eight Hundred,461421559,372755,461048804,2020.csv,2020,0.0008078404502985089,0.9991921595497015
239,Gladiator,460583960,187705427,272878533,2000.csv,2000,0.4075379155626696,0.5924620844373304
240,X-Men: The Last Stand,460435291,234362462,226072829,2006.csv,2006,0.5090019522417538,0.49099804775824624
241,National Treasure: Book of Secrets,459242249,219964115,239278134,2007.csv,2007,0.47897186175481865,0.5210281382451813
242,Lucy,458863600,126663600,332200000,2014.csv,2014,0.27603758502526676,0.7239624149747332
243,300,456068181,210614939,245453242,2007.csv,2007,0.4618058171438187,0.5381941828561814
244,The Last Samurai,454627263,111127263,343500000,2003.csv,2003,0.24443598535356645,0.7555640146464335
245,Demon Slayer the Movie: Mugen Train,453210959,49505008,403705951,2020.csv,2020,0.10923170990664416,0.8907682900933558
246,Dying to Survive,451176639,0,451176639,2018.csv,2018,0.0,1.0
247,Ocean's Eleven,450717150,183417150,267300000,2001.csv,2001,0.4069451317749946,0.5930548682250054
248,"My People, My Country",450064993,2356683,447708310,2019.csv,2019,0.005236317057878794,0.9947636829421213
249,Thor,449326618,181030624,268295994,2011.csv,2011,0.40289316668081304,0.597106833319187
250,Pearl Harbor,449220945,198542554,250678391,2001.csv,2001,0.44197083018914,0.55802916981086
251,Tarzan,448191819,171091819,277100000,1999.csv,1999,0.3817379339536762,0.6182620660463238
252,La La Land,447407695,151101803,296305892,2016.csv,2016,0.3377273227274287,0.6622726772725712
253,The Bourne Ultimatum,444100035,227471070,216628965,2007.csv,2007,0.5122068274549899,0.48779317254501003
254,Alvin and the Chipmunks: The Squeakquel,443140005,219614612,223525393,2009.csv,2009,0.4955874205038202,0.5044125794961798
255,Les Misérables,442299309,148809770,293489539,2012.csv,2012,0.3364458568484899,0.6635541431515101
256,Men in Black II,441818803,190418803,251400000,2002.csv,2002,0.43098845433248795,0.569011545667512
257,Terminator Genisys,440603537,89760956,350842581,2015.csv,2015,0.20372273134974855,0.7962772686502514
258,Warcraft,439048914,47365290,391683624,2016.csv,2016,0.10788157877097038,0.8921184212290296
259,A Star Is Born,436188866,215288866,220900000,2018.csv,2018,0.4935679995096436,0.5064320004903564
260,The Greatest Showman,434993183,174340174,260653009,2017.csv,2017,0.4007882900546513,0.5992117099453488
261,Terminator 3: Rise of the Machines,433371112,150371112,283000000,2003.csv,2003,0.34698000821060726,0.6530199917893927
262,The Mummy Returns,433013274,202019785,230993489,2001.csv,2001,0.46654409259518453,0.5334559074048155
263,Pokémon: Detective Pikachu,433005346,144105346,288900000,2019.csv,2019,0.3328026947731957,0.6671973052268043
264,Shang-Chi and the Legend of the Ten Rings,432243292,224543292,207700000,2021.csv,2021,0.5194835782437082,0.48051642175629183
265,Die Another Day,431971116,160942139,271028977,2002.csv,2002,0.37257615854111875,0.6274238414588812
266,The Secret Life of Pets 2,430051293,158874395,271176898,2019.csv,2019,0.36943126921374003,0.63056873078626
267,Cast Away,429632142,233632142,196000000,2000.csv,2000,0.5437957712204875,0.4562042287795125
268,Rampage,428028233,101028233,327000000,2018.csv,2018,0.2360317035441912,0.7639682964558088
269,The Matrix Revolutions,427343298,139313948,288029350,2003.csv,2003,0.32600007687496246,0.6739999231250375
270,The Intouchables,426588510,10198820,416389690,2011.csv,2011,0.023907863810021513,0.9760921361899785
271,Bad Boys for Life,426505244,206305244,220200000,2020.csv,2020,0.4837109200936343,0.5162890799063657
272,Django Unchained,425368238,162805434,262562804,2012.csv,2012,0.38273998727662406,0.6172600127233759
273,The King's Speech,423999102,135453143,288545959,2010.csv,2010,0.3194656365097679,0.6805343634902321
274,"My People, My Homeland",422390820,0,422390820,2020.csv,2020,0.0,1.0
275,Minions: The Rise of Gru,420306360,225158360,195148000,2022.csv,2022,0.5357005780259904,0.46429942197400964
276,The Chronicles of Narnia: Prince Caspian,419665568,141621490,278044078,2008.csv,2008,0.33746273413595845,0.6625372658640415
277,Sex and the City,418765321,152647258,266118063,2008.csv,2008,0.3645174286053166,0.6354825713946833
278,The Captain,417282021,706572,416575449,2019.csv,2019,0.0016932720904359309,0.9983067279095641
279,The Chronicles of Narnia: The Voyage of the Dawn Treader,415686217,104386950,311299267,2010.csv,2010,0.25111958427045944,0.7488804157295406
280,Jason Bourne,415484914,162434410,253050504,2016.csv,2016,0.39095140287091146,0.6090485971290885
281,The Wolverine,414828246,132556852,282271394,2013.csv,2013,0.3195463502743253,0.6804536497256747
282,Kingsman: The Secret Service,414351546,128261724,286089822,2015.csv,2015,0.3095480763573644,0.6904519236426355
283,Night at the Museum: Battle of the Smithsonian,413106170,177243721,235862449,2009.csv,2009,0.4290512557582957,0.5709487442417043
284,Pacific Rim,411002906,101802906,309200000,2013.csv,2013,0.24769388370212642,0.7523061162978736
285,Kingsman: The Golden Circle,410902662,100234838,310667824,2017.csv,2017,0.24393815681826855,0.7560618431817314
286,The Mummy,409231607,80227895,329003712,2017.csv,2017,0.196045206742792,0.803954793257208
287,Ice Age: Collision Course,408579038,64063008,344516030,2016.csv,2016,0.15679465180981703,0.843205348190183
288,Signs,408247917,227966634,180281283,2002.csv,2002,0.5584024425040728,0.44159755749592716
289,X2: X-Men United,407711549,214949694,192761855,2003.csv,2003,0.5272102164562427,0.4727897835437573
290,Twilight,407187715,192769854,214417861,2008.csv,2008,0.47341765701354716,0.5265823429864528
291,Sing 2,406453646,162790990,243662656,2021.csv,2021,0.4005155116753461,0.5994844883246538
292,Fantastic Beasts: The Secrets of Dumbledore,405161334,95850844,309310490,2022.csv,2022,0.23657450984698358,0.7634254901530164
293,Alita: Battle Angel,404980543,85838210,319142333,2019.csv,2019,0.21195638033405473,0.7880436196659453
294,The Mummy: Tomb of the Dragon Emperor,403449830,102491776,300958054,2008.csv,2008,0.2540384661954127,0.7459615338045873
295,Prometheus,403354469,126477084,276877385,2012.csv,2012,0.3135631156227502,0.6864368843772498
296,Eternals,402064899,164870234,237194665,2021.csv,2021,0.41005876019035425,0.5899412398096457
297,Sonic the Hedgehog 2,401872904,190872904,211000000,2022.csv,2022,0.47495838136925,0.5250416186307499
298,Dune,401847900,108327830,293520070,2021.csv,2021,0.2695742095454524,0.7304257904545476
299,Uncharted,401747690,148647690,253100000,2022.csv,2022,0.37000260038831834,0.6299973996116817
300,TRON: Legacy,400062763,172062763,228000000,2010.csv,2010,0.4300894232438224,0.5699105767561776
301,Mission: Impossible III,398479497,134029801,264449696,2006.csv,2006,0.33635306711903423,0.6636469328809658
302,Snow White and the Huntsman,396592829,155332381,241260448,2012.csv,2012,0.39166714484391246,0.6083328551560876
303,Mamma Mia! Here We Go Again,395044706,120634935,274409771,2018.csv,2018,0.3053703369967449,0.6946296630032551
304,Solo: A Star Wars Story,392924807,213767512,179157295,2018.csv,2018,0.5440417815106289,0.4559582184893712
305,The Wolf of Wall Street,392000694,116900694,275100000,2013.csv,2013,0.2982155281592435,0.7017844718407565
306,Superman Returns,391081192,200081192,191000000,2006.csv,2006,0.5116103665757468,0.48838963342425323
307,Independence Day: Resurgence,389681935,103144286,286537649,2016.csv,2016,0.26468839516514925,0.7353116048348508
308,Live Free or Die Hard,388156011,134529403,253626608,2007.csv,2007,0.34658590666524547,0.6534140933347545
309,Monster Hunt,387053506,32766,387020740,2015.csv,2015,8.465496240718718e-05,0.9999153450375928
310,Godzilla: King of the Monsters,386600138,110500138,276100000,2019.csv,2019,0.2858253971963145,0.7141746028036855
311,Home,386041607,177397510,208644097,2015.csv,2015,0.45952950869360565,0.5404704913063944
312,Star Trek,385680446,257730019,127950427,2009.csv,2009,0.6682475652395403,0.3317524347604597
313,1917,384919389,159227644,225691745,2019.csv,2019,0.4136649089401937,0.5863350910598063
314,Happy Feet,384335608,198000317,186335291,2006.csv,2006,0.515175572803028,0.48482442719697205
315,Cars 3,383930656,152901115,231029541,2017.csv,2017,0.3982519046356121,0.6017480953643879
316,Ice Age,383257136,176387405,206869731,2002.csv,2002,0.4602325395449388,0.5397674604550612
317,Fifty Shades Darker,381545846,114581250,266964596,2017.csv,2017,0.3003079477898444,0.6996920522101556
318,Monsters vs. Aliens,381509870,198351526,183158344,2009.csv,2009,0.5199119121085911,0.48008808789140894
319,Black Widow,379751655,183651655,196100000,2021.csv,2021,0.4836098870984512,0.5163901129015488
320,Slumdog Millionaire,378410113,141319928,237090185,2008.csv,2008,0.37345705927262046,0.6265429407273796
321,Taken 2,376141306,139854287,236287019,2012.csv,2012,0.3718131584304118,0.6281868415695883
322,G.I. Joe: Retaliation,375740705,122523060,253217645,2013.csv,2013,0.3260840743884802,0.6739159256115198
323,Spider-Man: Into the Spider-Verse,375540831,190241310,185299521,2018.csv,2018,0.5065795628491859,0.49342043715081413
324,Mad Max: Fury Road,374736354,153636354,221100000,2015.csv,2015,0.4099851865453118,0.5900148134546882
325,Shark Tale,374583879,160861908,213721971,2004.csv,2004,0.42944162047080514,0.5705583795291949
326,Once Upon a Time... In Hollywood,374375059,142502728,231872331,2019.csv,2019,0.3806416174748436,0.6193583825251564
327,What Women Want,374111707,182811707,191300000,2000.csv,2000,0.4886554031307018,0.5113445968692982
328,The Adventures of Tintin,373993951,77591831,296402120,2011.csv,2011,0.20746814431766036,0.7925318556823396
329,Penguins of Madagascar,373515621,83850911,289664710,2014.csv,2014,0.22449104210289508,0.775508957897105
330,X-Men Origins: Wolverine,373062864,179883157,193179707,2009.csv,2009,0.48217920988243956,0.5178207901175604
331,The Golden Compass,372234864,70107728,302127136,2007.csv,2007,0.188342723318899,0.811657276681101
332,Fifty Shades Freed,371985018,100407760,271577258,2018.csv,2018,0.26992420431298125,0.7300757956870187
333,Batman Begins,371853783,205343774,166510009,2005.csv,2005,0.552216444709398,0.44778355529060193
334,Hitch,371594210,179495555,192098655,2005.csv,2005,0.48304185094810814,0.5169581490518919
335,Terminator Salvation,371353001,125322469,246030532,2009.csv,2009,0.33747530964479805,0.6625246903552019
336,Captain America: The First Avenger,370569774,176654505,193915269,2011.csv,2011,0.4767105074252494,0.5232894925747505
337,Edge of Tomorrow,370541256,100206256,270335000,2014.csv,2014,0.2704321162013873,0.7295678837986127
338,Gone Girl,369330363,167767189,201563174,2014.csv,2014,0.4542469447604014,0.5457530552395986
339,Jurassic Park III,368780809,181171875,187608934,2001.csv,2001,0.49127251358679025,0.5087274864132098
340,My Big Fat Greek Wedding,368744044,241438208,127305836,2002.csv,2002,0.6547582582784713,0.34524174172152866
341,Hello Mr. Billionaire,366961907,0,366961907,2018.csv,2018,0.0,1.0
342,Shazam!,365971656,140371656,225600000,2019.csv,2019,0.3835588185550632,0.6164411814449369
343,The Nun,365550119,117450119,248100000,2018.csv,2018,0.32129689718415877,0.6787031028158412
344,Alvin and the Chipmunks,365352546,217326974,148025572,2007.csv,2007,0.5948418216305519,0.4051581783694481
345,Tenet,365294355,58504105,306790250,2020.csv,2020,0.1601560609936061,0.8398439390063939
346,Night at the Museum: Secret of the Tomb,363204635,113746621,249458014,2014.csv,2014,0.313175025973994,0.6868249740260061
347,Ocean's Twelve,362744280,125544280,237200000,2004.csv,2004,0.34609582265501193,0.6539041773449881
348,Planet of the Apes,362211740,180011740,182200000,2001.csv,2001,0.4969793082907804,0.5030206917092196
349,The Hangover Part III,362000072,112200072,249800000,2013.csv,2013,0.3099448886297459,0.6900551113702541
350,Monster Hunt 2,361682618,706153,360976465,2018.csv,2018,0.0019524106629862981,0.9980475893370137
351,Fast & Furious,360364265,155064265,205300000,2009.csv,2009,0.43029867292751683,0.5697013270724832
352,Noah,359200044,101200044,258000000,2014.csv,2014,0.28173728174710355,0.7182627182528964
353,The Karate Kid,359126022,176591618,182534404,2010.csv,2010,0.4917260437340294,0.5082739562659706
354,Hotel Transylvania,358375603,148313048,210062555,2012.csv,2012,0.4138480598524448,0.5861519401475552
355,Minority Report,358372926,132072926,226300000,2002.csv,2002,0.3685348875936013,0.6314651124063987
356,Your Name.,357986087,5017246,352968841,2016.csv,2016,0.014015198305737508,0.9859848016942625
357,The Legend of Tarzan,356700357,126643061,230057296,2016.csv,2016,0.3550404660794887,0.6449595339205113
358,American Beauty,356296601,130096601,226200000,1999.csv,1999,0.3651356780695194,0.6348643219304806
359,The Great Gatsby,353641895,144840419,208801476,2013.csv,2013,0.40956804340164504,0.5904319565983549
360,Dumbo,353284621,114766307,238518314,2019.csv,2019,0.32485508900768145,0.6751449109923185
361,"I, Robot",353133898,144801023,208332875,2004.csv,2004,0.4100456620564928,0.5899543379435072
362,Murder on the Orient Express,352789811,102826543,249963268,2017.csv,2017,0.29146687289106543,0.7085331271089346
363,X-Men: First Class,352616690,146408305,206208385,2011.csv,2011,0.41520526155469273,0.5847947384453073
364,The Angry Birds Movie,352333929,107509366,244824563,2016.csv,2016,0.3051348653964007,0.6948651346035993
365,Catch Me If You Can,352114312,164615351,187498961,2002.csv,2002,0.4675054247723961,0.5324945752276039
366,Now You See Me,351723989,117723989,234000000,2013.csv,2013,0.3347056006464205,0.6652943993535795
367,Hannibal,351692268,165092268,186600000,2001.csv,2001,0.46942251229702897,0.5305774877029711
368,Peter Rabbit,351266433,115253424,236013009,2018.csv,2018,0.3281082767165515,0.6718917232834485
369,Titanic 2012 3D Release,350449521,57884114,292565407,2012.csv,2012,0.16517104613191924,0.8348289538680808
370,Dinosaur,349822765,137748063,212074702,2000.csv,2000,0.39376529140406286,0.6062347085959372
371,Mary Poppins Returns,349537494,171958438,177579056,2018.csv,2018,0.4919599211865952,0.5080400788134047
372,The Lorax,348840316,214030500,134809816,2012.csv,2012,0.6135486358176558,0.3864513641823441
373,The Maze Runner,348319861,102427862,245891999,2014.csv,2014,0.2940626517992323,0.7059373482007677
374,The Smurfs 2,347545360,71017784,276527576,2013.csv,2013,0.2043410506185437,0.7956589493814563
375,National Treasure,347512318,173008894,174503424,2004.csv,2004,0.4978496733459675,0.5021503266540325
376,Rush Hour 2,347325802,226164286,121161516,2001.csv,2001,0.6511588966258257,0.3488411033741743
377,Trolls,346864462,153707064,193157398,2016.csv,2016,0.44313292608223437,0.5568670739177656
378,xXx: Return of Xander Cage,346118277,44898413,301219864,2017.csv,2017,0.12971985585147242,0.8702801441485276
379,How the Grinch Stole Christmas,345141403,260044825,85096578,2000.csv,2000,0.7534443064195344,0.24655569358046564
380,Star Trek Beyond,343471816,158848340,184623476,2016.csv,2016,0.462478528369268,0.537521471630732
381,Alvin and the Chipmunks: Chipwrecked,342695435,133110742,209584693,2011.csv,2011,0.3884228630007867,0.6115771369992133
382,Wanted,342463063,134508551,207954512,2008.csv,2008,0.39276805452154706,0.6072319454784529
383,A Quiet Place,340939361,188024361,152915000,2018.csv,2018,0.5514891576276522,0.44851084237234784
384,Enchanted,340487652,127807262,212680390,2007.csv,2007,0.37536533630300345,0.6246346636969966
385,Over the Hedge,339795890,155019340,184776550,2006.csv,2006,0.4562131107589324,0.5437868892410677
386,300: Rise of an Empire,337580051,106580051,231000000,2014.csv,2014,0.31571785916935,0.68428214083065
387,Prince of Persia: The Sands of Time,336365676,90759676,245606000,2009.csv,2009,0.2698244276267951,0.730175572373205
388,The Curious Case of Benjamin Button,335802786,127509326,208293460,2008.csv,2008,0.3797149139793021,0.6202850860206979
389,Journey 2: The Mysterious Island,335260290,103860290,231400000,2012.csv,2012,0.30979001420060814,0.6902099857993919
390,The Great Wall,334933831,45540830,289393001,2016.csv,2016,0.13596963276008986,0.8640303672399101
391,Now You See Me 2,334897606,65075540,269822066,2016.csv,2016,0.19431473630778956,0.8056852636922105
392,Never Say Die,334530869,0,334530869,2017.csv,2017,0.0,1.0
393,Fantastic Four,333535934,154696080,178839854,2005.csv,2005,0.46380633758040596,0.5361936624195941
394,The Good Dinosaur,332207671,123087120,209120551,2015.csv,2015,0.3705125761530052,0.6294874238469947
395,Free Guy,331526598,121626598,209900000,2021.csv,2021,0.36686829573776764,0.6331317042622324
396,22 Jump Street,331333876,191719337,139614539,2014.csv,2014,0.5786288420445123,0.4213711579554878
397,Meet the Parents,330444045,166244045,164200000,2000.csv,2000,0.5030928761327806,0.49690712386721936
398,Black Swan,329398046,106954678,222443368,2010.csv,2010,0.32469736629828094,0.6753026337017191
399,Thor: Love and Thunder,329178181,170003041,159175140,2022.csv,2022,0.5164468692413122,0.4835531307586878
400,The Perfect Storm,328718434,182618434,146100000,2000.csv,2000,0.5555466779815579,0.44445332201844207
401,Crazy Alien,327598891,0,327598891,2019.csv,2019,0.0,1.0
402,John Wick: Chapter 3 - Parabellum,326709727,171015687,155694040,2019.csv,2019,0.5234484096030603,0.47655159039693973
403,The Devil Wears Prada,326705902,124740460,201965442,2006.csv,2006,0.38181269219923675,0.6181873078007633
404,Taken 3,326479141,89256424,237222717,2015.csv,2015,0.27339089329446625,0.7266091067055338
405,A Christmas Carol,325286646,137855863,187430783,2009.csv,2009,0.4237981014443489,0.5762018985556512
406,The SpongeBob Movie: Sponge Out of Water,325186032,162994032,162192000,2015.csv,2015,0.5012331894993571,0.4987668105006429
407,Megamind,321885765,148415853,173469912,2010.csv,2010,0.4610823749848024,0.5389176250151976
408,Green Book,321752656,85080171,236672485,2018.csv,2018,0.26442725308847176,0.7355727469115282
409,Robin Hood,321669741,105269730,216400011,2010.csv,2010,0.327260281532045,0.672739718467955
410,Inglourious Basterds,321455689,120540719,200914970,2009.csv,2009,0.37498393441094147,0.6250160655890585
411,The Conjuring 2,320392818,102470008,217922810,2016.csv,2016,0.31982617038562955,0.6801738296143705
412,Sonic the Hedgehog,319715683,148974665,170741018,2020.csv,2020,0.46595982906475064,0.5340401709352494
413,The Last Airbender,319713881,131772187,187941694,2010.csv,2010,0.4121566026093187,0.5878433973906814
414,The Conjuring,319494638,137400141,182094497,2013.csv,2013,0.4300546070510266,0.5699453929489734
415,The Proposal,317375031,163958031,153417000,2009.csv,2009,0.5166065852231456,0.4833934147768543
416,The Expendables 2,314975955,85028192,229947763,2012.csv,2012,0.26995137454222495,0.730048625457775
417,Chicken Little,314432837,135386665,179046172,2005.csv,2005,0.4305741928601433,0.5694258071398567
418,A Beautiful Mind,313542341,170742341,142800000,2001.csv,2001,0.5445591190505272,0.45544088094947277
419,Maze Runner: The Scorch Trials,312296056,81697192,230598864,2015.csv,2015,0.2616017411375826,0.7383982588624174
420,Resident Evil: The Final Chapter,312242626,26830068,285412558,2016.csv,2016,0.085926986791355,0.914073013208645
421,The Lego Batman Movie,311950384,175750384,136200000,2017.csv,2017,0.5633921066114155,0.4366078933885845
422,Knives Out,311605581,165363234,146242347,2019.csv,2019,0.5306812332093628,0.46931876679063717
423,Ocean's Thirteen,311312624,117154724,194157900,2007.csv,2007,0.376325002483677,0.623674997516323
424,Little Fockers,310650585,148438600,162211985,2010.csv,2010,0.47783138731253316,0.5221686126874668
425,Bolt,309979994,114053579,195926415,2008.csv,2008,0.3679385160579105,0.6320614839420895
426,Runaway Bride,309460292,152257509,157202783,1999.csv,1999,0.4920098407972807,0.5079901592027193
427,The Blind Side,309208309,255959475,53248834,2009.csv,2009,0.8277897700349314,0.17221022996506863
428,The Ex-File 3: The Return of The Exes,307592427,838959,306753468,2017.csv,2017,0.002727502130603495,0.9972724978693965
429,The Fault in Our Stars,307166834,124872350,182294484,2014.csv,2014,0.40652940414784494,0.593470595852155
430,The Pursuit of Happyness,307127625,163566459,143561166,2006.csv,2006,0.5325683712105025,0.4674316287894975
431,Rise of the Guardians,306941670,103412758,203528912,2012.csv,2012,0.33691338813657984,0.6630866118634202
432,Chicago,306776732,170687518,136089214,2002.csv,2002,0.556390039385386,0.443609960614614
433,Annabelle: Creation,306515884,102092201,204423683,2017.csv,2017,0.33307311734617967,0.6669268826538203
434,Wonder,305937718,132422809,173514909,2017.csv,2017,0.43284237676114196,0.5671576232388581
435,Skyscraper,304868961,68420120,236448841,2018.csv,2018,0.22442468323300382,0.7755753167669962
436,A Good Day to Die Hard,304654182,67349198,237304984,2013.csv,2013,0.22106769569964413,0.7789323043003559
437,Dangal,303723636,12391761,291331875,2016.csv,2016,0.04079946217949267,0.9592005378205073
438,Passengers,303144152,100014699,203129453,2016.csv,2016,0.3299245535173642,0.6700754464826357
439,Battleship,303025485,65422625,237602860,2012.csv,2012,0.21589809517176417,0.7841019048282358
440,G.I. Joe: The Rise of Cobra,302469017,150201498,152267519,2009.csv,2009,0.49658473945448767,0.5034152605455123
441,Wrath of the Titans,301970083,83670083,218300000,2012.csv,2012,0.27708070338875257,0.7229192966112474
442,Fantastic 4: Rise of the Silver Surfer,301913131,131921738,169991393,2007.csv,2007,0.436952634564278,0.563047365435722
443,Resident Evil: Afterlife,300228084,60128566,240099518,2010.csv,2010,0.20027628727764188,0.7997237127223581
444,Van Helsing,300157638,120177084,179980554,2004.csv,2004,0.4003798963796483,0.5996201036203517
445,Stuart Little,300135367,140035367,160100000,1999.csv,1999,0.46657402757869587,0.5334259724213042
446,Alice Through the Looking Glass,299457024,77041381,222415643,2016.csv,2016,0.257270241889534,0.7427297581104659
447,Real Steel,299268508,85468508,213800000,2011.csv,2011,0.28559138604720813,0.7144086139527919
448,Horton Hears a Who!,298572799,154529439,144043360,2008.csv,2008,0.5175603387768757,0.48243966122312437
449,Ocean's Eight,297718711,140218711,157500000,2018.csv,2018,0.47097715333048046,0.5290228466695195
450,A Quiet Place Part II,297372261,160072261,137300000,2021.csv,2021,0.5382891479578857,0.4617108520421143
451,The Divergent Series: Insurgent,297002527,130179072,166823455,2015.csv,2015,0.4383096444159211,0.5616903555840789
452,Austin Powers in Goldmember,296938801,213307889,83630912,2002.csv,2002,0.7183564030084435,0.2816435969915565
453,Miss Peregrine's Home for Peculiar Children,296482446,87242834,209239612,2016.csv,2016,0.29425969455203427,0.7057403054479657
454,X-Men,296339528,157299718,139039810,2000.csv,2000,0.5308090994867212,0.46919090051327883
455,Ferdinand,296069199,84410380,211658819,2017.csv,2017,0.28510355107894897,0.7148964489210511
456,Shutter Island,294804195,128012934,166791261,2010.csv,2010,0.4342303677191568,0.5657696322808432
457,Bee Movie,293514336,126631277,166883059,2007.csv,2007,0.431431318571097,0.568568681428903
458,Salt,293503354,118311368,175191986,2010.csv,2010,0.4031005655901295,0.5968994344098705
459,G-Force,292817841,119436770,173381071,2009.csv,2009,0.4078876122852091,0.5921123877147909
460,The Departed,291465034,132384315,159080719,2006.csv,2006,0.45420307603690124,0.5457969239630988
461,What Lies Beneath,291420351,155464351,135956000,2000.csv,2000,0.533471154181679,0.46652884581832105
462,Pacific Rim: Uprising,290930148,59874525,231055623,2018.csv,2018,0.20580378283793402,0.794196217162066
463,Sex and the City 2,290745055,95347692,195397363,2010.csv,2010,0.3279426093764518,0.6720573906235482
464,The Bourne Supremacy,290633422,176241941,114391481,2004.csv,2004,0.6064063100079384,0.39359368999206157
465,Divergent,288885818,150947895,137937923,2014.csv,2014,0.5225174985917792,0.47748250140822074
466,Wedding Crashers,288467645,209255921,79211724,2005.csv,2005,0.7254051697894923,0.2745948302105077
467,Bridesmaids,288383523,169106725,119276798,2011.csv,2011,0.5863952393701772,0.4136047606298228
468,Maze Runner: The Death Cure,288175335,58032443,230142892,2018.csv,2018,0.2013789382772818,0.7986210617227182
469,American Pie 2,287553595,145103595,142450000,2001.csv,2001,0.5046140876798985,0.4953859123201016
470,Pitch Perfect 2,287144079,184296230,102847849,2015.csv,2015,0.6418249355578737,0.35817506444212627
471,The Green Mile,286801374,136801374,150000000,1999.csv,1999,0.4769899533326504,0.5230100466673496
472,Oblivion,286168572,89107235,197061337,2013.csv,2013,0.3113802273158074,0.6886197726841926
473,Elysium,286140700,93050117,193090583,2013.csv,2013,0.3251900795657521,0.6748099204342479
474,The Polar Express,286000505,162775358,123225147,2004.csv,2004,0.5691436034352457,0.43085639656475433
475,John Carter,284139100,73078100,211061000,2012.csv,2012,0.2571912841280908,0.7428087158719092
476,Turbo,282570682,83028128,199542554,2013.csv,2013,0.29383136074959115,0.7061686392504088
477,Paddington,282370135,76271832,206098303,2014.csv,2014,0.2701129565277858,0.7298870434722142
478,Bridget Jones's Diary,281929795,71543427,210386368,2001.csv,2001,0.25376327110087815,0.7462367288991218
479,The Tourist,278780441,67631157,211149284,2010.csv,2010,0.24259649191099458,0.7574035080890055
480,Split,278454358,138291365,140162993,2017.csv,2017,0.4966392553281569,0.5033607446718431
481,Scary Movie,278019771,157019771,121000000,2000.csv,2000,0.5647791537818366,0.43522084621816337
482,xXx,277448382,142109382,135339000,2002.csv,2002,0.5122011560334131,0.4877988439665869
483,The Bourne Legacy,276144750,113203870,162940880,2012.csv,2012,0.4099439514964525,0.5900560485035475
484,Mr. Peabody & Sherman,275698039,111506430,164191609,2014.csv,2014,0.4044512989807664,0.5955487010192336
485,Scooby-Doo,275650703,153294164,122356539,2002.csv,2002,0.556117442588202,0.44388255741179805
486,Lincoln,275293450,182207973,93085477,2012.csv,2012,0.6618681737614898,0.33813182623851024
487,Spirited Away,274925095,10055859,264869236,2001.csv,2001,0.03657672283426873,0.9634232771657313
488,Lara Croft: Tomb Raider,274703340,131168070,143535270,2001.csv,2001,0.4774898987394911,0.5225101012605089
489,Tomb Raider,274650803,58250803,216400000,2018.csv,2018,0.21209041577060309,0.7879095842293969
490,The Expendables,274470394,103068524,171401870,2010.csv,2010,0.3755178199656754,0.6244821800343245
491,Cloudy with a Chance of Meatballs 2,274325949,119793567,154532382,2013.csv,2013,0.43668332302023677,0.5633166769797632
492,Bad Boys II,273339556,138608444,134731112,2003.csv,2003,0.5070925190205547,0.4929074809794452
493,Lilo & Stitch,273144151,145794338,127349813,2002.csv,2002,0.5337633534023578,0.46623664659764213
494,Grown Ups,271430189,162001186,109429003,2010.csv,2010,0.5968429178671795,0.40315708213282053
495,Neighbors,270665134,150157400,120507734,2014.csv,2014,0.5547718606416444,0.44522813935835565
496,We're the Millers,269994119,150394119,119600000,2012.csv,2012,0.5570273884373015,0.4429726115626985
497,Gran Torino,269958228,148095302,121862926,2008.csv,2008,0.5485859908667055,0.4514140091332945
498,"10,000 BC",269784201,94784201,175000000,2008.csv,2008,0.35133340146927283,0.6486665985307272
499,American Gangster,269755430,130164645,139590785,2007.csv,2007,0.4825283591140315,0.5174716408859684
500,Epic,268426634,107518682,160907952,2013.csv,2013,0.4005514668861064,0.5994485331138936
501,Exodus: Gods and Kings,268175631,65014513,203161118,2014.csv,2014,0.24243259075243864,0.7575674092475614
502,The Princess and the Frog,267045765,104400899,162644866,2009.csv,2009,0.3909475928217772,0.6090524071782228
503,Something's Gotta Give,265328738,124728738,140600000,2003.csv,2003,0.4700913249736257,0.5299086750263743
504,Bridget Jones: The Edge of Reason,265126918,40226215,224900703,2004.csv,2004,0.15172437149516443,0.8482756285048355
505,The Incredible Hulk,264770996,134806913,129964083,2008.csv,2008,0.5091453181677045,0.4908546818322956
506,Charlie's Angels,264105545,125305545,138800000,2000.csv,2000,0.47445253373987284,0.5255474662601272
507,Borat: Cultural Learnings of America for Make Benefit Glorious Nation of Kazakhstan,262552893,128505958,134046935,2006.csv,2006,0.48944788431639946,0.5105521156836006
508,Robots,262511490,128200012,134311478,2005.csv,2005,0.48835962189693105,0.511640378103069
509,Knight and Day 2010 Re-release,261930436,76423035,185507401,2010.csv,2010,0.2917684411444266,0.7082315588555734
510,This Is It,261183588,72091016,189092572,2009.csv,2009,0.27601663853396485,0.7239833614660351
511,Terminator: Dark Fate,261119292,62253077,198866215,2019.csv,2019,0.23840856998034446,0.7615914300196556
512,The Lone Ranger,260502115,89302115,171200000,2013.csv,2013,0.34280763900899613,0.6571923609910039
513,Super 8,260095986,127004179,133091807,2011.csv,2011,0.4882973434276683,0.5117026565723317
514,Mojin: The Lost Legend,259368448,1243810,258124638,2015.csv,2015,0.004795533186827721,0.9952044668131723
515,Blade Runner 2049,259239658,92054159,167185499,2017.csv,2017,0.35509288860425825,0.6449071113957418
516,Charlie's Angels: Full Throttle,259175788,100830111,158345677,2003.csv,2003,0.38904139841951596,0.6109586015804841
517,Parasite,258632621,53369749,205262872,2019.csv,2019,0.2063535094438068,0.7936464905561932
518,Rush Hour 3,258097122,140125968,117971154,2007.csv,2007,0.542919529339037,0.457080470660963
519,Kung Fu Yoga,257743016,362657,257380359,2017.csv,2017,0.0014070487946800467,0.99859295120532
520,Annabelle,257047661,84273813,172773848,2014.csv,2014,0.3278528684997449,0.6721471315002551
521,The Village,256697520,114197520,142500000,2003.csv,2003,0.44487192552541993,0.55512807447458
522,Encanto,256450065,96093622,160356443,2021.csv,2021,0.37470695123434655,0.6252930487656535
523,Lost in Hong Kong,256283912,1302281,254981631,2015.csv,2015,0.005081399725161055,0.9949186002748389
524,Erin Brockovich,256271286,125595205,130676081,2000.csv,2000,0.4900869190627935,0.5099130809372066
525,Pegasus,255863112,0,255863112,2019.csv,2019,0.0,1.0
526,Marley & Me,255743093,143153751,112589342,2008.csv,2008,0.5597560791211671,0.4402439208788329
527,Halloween,255485178,159342015,96143163,2018.csv,2018,0.6236839892136522,0.37631601078634785
528,Get Out,255407969,176040665,79367304,2017.csv,2017,0.6892528282858708,0.31074717171412924
529,Us,255184580,175084580,80100000,2019.csv,2019,0.6861095603817441,0.3138904396182559
530,Baahubali 2: The Conclusion,254158390,20186659,233971731,2017.csv,2017,0.07942550706274147,0.9205744929372586
531,Men in Black: International,253890701,80001807,173888894,2019.csv,2019,0.31510333653377876,0.6848966634662212
532,Wild Hogs,253625427,168273550,85351877,2007.csv,2007,0.6634727124579666,0.33652728754203337
533,High School Musical 3: Senior Year,252909177,90559416,162349761,2008.csv,2008,0.3580708975222358,0.6419291024777641
534,X-Men: Dark Phoenix,252442974,65845974,186597000,2019.csv,2019,0.26083504308580996,0.73916495691419
535,True Grit,252276927,171243005,81033922,2010.csv,2010,0.6787898007018296,0.32121019929817046
536,American Hustle,251171807,150117807,101054000,2013.csv,2013,0.5976698133162692,0.4023301866837308
537,Eragon,250425512,75030163,175395349,2006.csv,2006,0.2996107002069342,0.7003892997930659
538,Brother Bear,250397798,85336277,165061521,2003.csv,2003,0.34080282527085165,0.6591971747291484
539,The Ring,249348933,129128133,120220800,2002.csv,2002,0.5178611813029094,0.48213881869709063
540,The Blair Witch Project,248639099,140539099,108100000,1999.csv,1999,0.5652333022651438,0.43476669773485627
541,Unbreakable,248118121,95011339,153106782,2000.csv,2000,0.3829278515292319,0.6170721484707681
542,Journey to the West: The Demons Strike Back,247585244,880346,246704898,2017.csv,2017,0.0035557288704976295,0.9964442711295024
543,Glass,246999039,111048468,135950571,2019.csv,2019,0.44959068848846817,0.5504093115115318
544,Grown Ups 2,246984278,133668525,113315753,2013.csv,2013,0.5412025659382255,0.4587974340617746
545,The Peanuts Movie,246233113,130178411,116054702,2015.csv,2015,0.5286795484732388,0.47132045152676116
546,Rango,245724603,123477607,122246996,2011.csv,2011,0.5025040451484624,0.4974959548515376
547,Teenage Mutant Ninja Turtles: Out of the Shadows,245623848,82051601,163572247,2016.csv,2016,0.3340538863311025,0.6659461136688974
548,Dark Shadows,245527149,79727149,165800000,2012.csv,2012,0.3247182616045446,0.6752817383954554
549,Dolittle,245439115,77047065,168392050,2020.csv,2020,0.31391518421992354,0.6860848157800764
550,The Bad Guys,245417995,96417995,149000000,2022.csv,2022,0.39287255606501065,0.6071274439349894
551,Hulk,245285165,132177234,113107931,2003.csv,2003,0.5388717006183394,0.4611282993816605
552,The Bravest,245179562,290217,244889345,2019.csv,2019,0.0011836916488169597,0.9988163083511831
553,Welcome to the Sticks,245144417,0,245144417,2008.csv,2008,0.0,1.0
554,Love Actually,244931766,59696144,185235622,2003.csv,2003,0.24372560968674026,0.7562743903132597
555,Pixels,244874809,78747585,166127224,2015.csv,2015,0.3215830379677805,0.6784169620322195
556,Hercules,244819862,72688614,172131248,2014.csv,2014,0.29690652304999665,0.7030934769500033
557,Journey to the Center of the Earth,244232688,101704370,142528318,2008.csv,2008,0.41642407014739974,0.5835759298526002
558,After Earth,243611982,60522097,183089885,2013.csv,2013,0.24843645416422908,0.7515635458357709
559,Cloudy with a Chance of Meatballs,243006126,124870275,118135851,2009.csv,2009,0.513856490185766,0.48614350981423404
560,8 Mile,242875078,116750901,126124177,2002.csv,2002,0.48070350388111865,0.5192964961188813
561,Daddy's Home,242786137,150357137,92429000,2015.csv,2015,0.6192986916711806,0.38070130832881943
562,RoboCop,242688965,58607007,184081958,2014.csv,2014,0.24149020125410317,0.7585097987458969
563,Alien: Covenant,240891763,74262031,166629732,2017.csv,2017,0.3082796608533269,0.6917203391466731
564,Sully,240797623,125070033,115727590,2016.csv,2016,0.5193989518742052,0.48060104812579485
565,Assassin's Creed,240697856,54647948,186049908,2016.csv,2016,0.2270396126835463,0.7729603873164537
566,Click,240685326,137355633,103329693,2006.csv,2006,0.570685530699948,0.42931446930005196
567,Legend of Deification,240663149,214670,240448479,2020.csv,2020,0.0008919936471038197,0.9991080063528962
568,Resident Evil: Retribution,240159255,42345531,197813724,2012.csv,2012,0.17632271136084263,0.8236772886391573
569,Planes,239258712,90288712,148970000,2013.csv,2013,0.37736854489127236,0.6226314551087276
570,Crazy Rich Asians,238532921,174532921,64000000,2018.csv,2018,0.7316932198218459,0.2683067801781541
571,Gulliver's Travels,237382724,42779261,194603463,2010.csv,2010,0.1802121918526809,0.8197878081473191
572,Gone in 60 Seconds,237202299,101648571,135553728,2000.csv,2000,0.4285311374659147,0.5714688625340854
573,Silver Linings Playbook,236412453,132092958,104319495,2012.csv,2012,0.5587394247797937,0.44126057522020634
574,2 Fast 2 Furious,236350661,127154901,109195760,2003.csv,2003,0.5379925762086191,0.4620074237913809
575,Hidden Figures,235956898,169607287,66349611,2016.csv,2016,0.7188062245164792,0.2811937754835207
576,A.I. Artificial Intelligence,235926552,78616689,157309863,2001.csv,2001,0.33322527004082186,0.6667747299591782
577,Spy,235666219,110825712,124840507,2015.csv,2015,0.47026558354551445,0.5297344164544856
578,American Pie,235483004,102561004,132922000,1999.csv,1999,0.4355346341683326,0.5644653658316674
579,Howl's Moving Castle,235347345,4711096,230636249,2004.csv,2004,0.020017629686878344,0.9799823703131216
580,American Reunion,234989584,57011521,177978063,2012.csv,2012,0.24261297045404362,0.7573870295459564
581,Big Daddy,234801895,163479795,71322100,1999.csv,1999,0.696245637199819,0.303754362800181
582,Alvin and the Chipmunks: The Road Chip,234798636,85886987,148911649,2015.csv,2015,0.3657899741802589,0.6342100258197412
583,The Imitation Game,233555708,91125683,142430025,2014.csv,2014,0.39016679909188945,0.6098332009081106
584,Cruella,233503234,86103234,147400000,2021.csv,2021,0.3687453596467105,0.6312546403532895
585,The Day the Earth Stood Still,233093859,79366978,153726881,2008.csv,2008,0.34049364638130597,0.659506353618694
586,American Wedding,232722935,104565114,128157821,2003.csv,2003,0.4493115987902095,0.5506884012097906
587,The Girl with the Dragon Tattoo,232617430,102515793,130101637,2011.csv,2011,0.44070555246010584,0.5592944475398941
588,Juno,232372681,143495265,88877416,2007.csv,2007,0.6175220958956015,0.3824779041043986
589,Argo,232325503,136025503,96300000,2012.csv,2012,0.5854953556261105,0.4145046443738895
590,Mr. Bean's Holiday,232225908,33302167,198923741,2007.csv,2007,0.14340418468726582,0.8565958153127342
591,Annabelle Comes Home,231252591,74152591,157100000,2019.csv,2019,0.32065626023623667,0.6793437397637634
592,Constantine,230884728,75976178,154908550,2005.csv,2005,0.32906541137705736,0.6709345886229426
593,Get Smart,230685453,130319208,100366245,2008.csv,2008,0.5649216554630343,0.43507834453696564
594,Ghostbusters,229147509,128350574,100796935,2016.csv,2016,0.5601220565744837,0.43987794342551634
595,Ghost Rider,228738393,115802596,112935797,2007.csv,2007,0.5062665452930764,0.49373345470692365
596,Goodbye Mr. Loser,228122928,1293626,226829302,2015.csv,2015,0.005670740820931423,0.9943292591790686
597,Paddington 2,227978523,40891591,187086932,2017.csv,2017,0.17936597913655225,0.8206340208634477
598,The Green Hornet,227817248,98780042,129037206,2011.csv,2011,0.4335933423267408,0.5664066576732593
599,Youth,227091290,1891956,225199334,2017.csv,2017,0.00833125744276674,0.9916687425572333
600,Baby Driver,226945087,107825862,119119225,2017.csv,2017,0.47511873213628986,0.5248812678637101
601,Immortals,226904017,83504017,143400000,2011.csv,2011,0.3680147143450528,0.6319852856549473
602,Taken,226837760,145000989,81836771,2008.csv,2008,0.6392277414483374,0.3607722585516627
603,Percy Jackson & the Olympians: The Lightning Thief,226497209,88768303,137728906,2010.csv,2010,0.39191786685548075,0.6080821331445192
604,Hansel & Gretel: Witch Hunters,226349749,55703475,170646274,2013.csv,2013,0.2460947062945495,0.7539052937054505
605,Better Days,225918798,1921657,223997141,2019.csv,2019,0.008505963279779843,0.9914940367202202
606,Valerian and the City of a Thousand Planets,225874228,41189488,184684740,2017.csv,2017,0.18235585513545174,0.8176441448645483
607,Ford v Ferrari,225508210,117624357,107883853,2019.csv,2019,0.521596783549477,0.47840321645052303
608,Jumper,225132113,80172128,144959985,2008.csv,2008,0.3561114713119581,0.6438885286880419
609,The Social Network,224920315,96962694,127957621,2010.csv,2010,0.4310979824121267,0.5689020175878733
610,Chicken Run,224834564,106834564,118000000,2000.csv,2000,0.47516966297050306,0.524830337029497
611,Flightplan,223387299,89707299,133680000,2005.csv,2005,0.40157743704130644,0.5984225629586936
612,Yes Man,223241637,97690976,125550661,2008.csv,2008,0.43760195146750336,0.5623980485324966
613,Non-Stop,222809600,92168600,130641000,2014.csv,2014,0.4136652998793589,0.5863347001206412
614,Fahrenheit 9/11,222446882,119194771,103252111,2004.csv,2004,0.5358347571713772,0.4641652428286228
615,Wild Wild West,222104681,113804681,108300000,1999.csv,1999,0.5123920868646618,0.4876079131353382
616,"My Country, My Parents",221715716,166807,221548909,2021.csv,2021,0.0007523463063845235,0.9992476536936155
617,Geostorm,221600160,33700160,187900000,2017.csv,2017,0.15207642449355632,0.8479235755064437
618,Jungle Cruise,220889446,116987516,103901930,2021.csv,2021,0.5296202155353317,0.4703797844646684
619,Scary Movie 3,220673217,110003217,110670000,2003.csv,2003,0.4984892072335176,0.5015107927664824
620,Elf,220443451,173398518,47044933,2003.csv,2003,0.7865895639603283,0.2134104360396717
621,Collateral,220239925,101005703,119234222,2004.csv,2004,0.4586166790603475,0.5413833209396525
622,Inferno,220021259,34343574,185677685,2016.csv,2016,0.15609207108482184,0.8439079289151782
623,Knocked Up,219922417,148768917,71153500,2007.csv,2007,0.6764609039377737,0.32353909606222636
624,Green Lantern,219851172,116601172,103250000,2011.csv,2011,0.5303641137742036,0.46963588622579644
625,What Happens in Vegas,219375562,80277646,139097916,2008.csv,2008,0.36593704999830384,0.6340629500016962
626,It's Complicated,219103655,112735375,106368280,2009.csv,2009,0.5145298694355418,0.4854701305644582
627,Captain Phillips,218791811,107100855,111690956,2013.csv,2013,0.4895103455220269,0.5104896544779731
628,The Terminal,218685607,77872883,140812724,2004.csv,2004,0.35609514530144637,0.6439048546985536
629,Jack Reacher,218340595,80070736,138269859,2012.csv,2012,0.3667239983476275,0.6332760016523725
630,Kingdom of Heaven,218122627,47398413,170724214,2005.csv,2005,0.2173016786561992,0.7826983213438008
631,The Emoji Movie,217776646,86089513,131687133,2017.csv,2017,0.39531104267259215,0.6046889573274078
632,Too Cool to Kill,217254604,185882,217068722,2022.csv,2022,0.000855595216753151,0.9991444047832468
633,Dracula Untold,217124280,56280355,160843925,2014.csv,2014,0.2592080213230874,0.7407919786769126
634,Central Intelligence,216972543,127440871,89531672,2016.csv,2016,0.5873594383783389,0.412640561621661
635,Million Dollar Baby,216763646,100492203,116271443,2004.csv,2004,0.4636026605679072,0.5363973394320928
636,The Help,216639112,169708112,46931000,2011.csv,2011,0.7833678343363962,0.21663216566360372
637,Little Women,216601214,108101214,108500000,2019.csv,2019,0.4990794465260938,0.5009205534739062
638,Valentine's Day,216485654,110485654,106000000,2010.csv,2010,0.5103601645585254,0.48963983544147455
639,Bad Teacher,216197492,100292856,115904636,2011.csv,2011,0.46389463204318765,0.5361053679568124
640,A Little Red Flower,216000000,0,216000000,2020.csv,2020,0.0,1.0
641,The Croods: A New Age,215905815,58568815,157337000,2020.csv,2020,0.271270206409216,0.728729793590784
642,Ted 2,215863606,81476385,134387221,2015.csv,2015,0.37744382441197616,0.6225561755880239
643,Vertical Limit,215663859,69243859,146420000,2000.csv,2000,0.3210730778957266,0.6789269221042734
644,The Patriot,215294342,113330342,101964000,2000.csv,2000,0.5263972148418095,0.47360278515819054
645,The Sorcerer's Apprentice,215283742,63150991,152132751,2010.csv,2010,0.29333841196424393,0.7066615880357561
646,Just Go with It,214945591,103028109,111917482,2011.csv,2011,0.4793218066054679,0.5206781933945321
647,The Expendables 3,214657577,39322544,175335033,2014.csv,2014,0.18318730952599918,0.8168126904740008
648,Creed II,214215889,115715889,98500000,2018.csv,2018,0.5401835015142131,0.45981649848578693
649,Public Enemies,214104620,97104620,117000000,2009.csv,2009,0.453538181474085,0.546461818525915
650,Smallfoot,214040103,83240103,130800000,2018.csv,2018,0.3888995652370808,0.6111004347629192
651,The Bourne Identity,214034224,121661683,92372541,2002.csv,2002,0.5684216324208039,0.4315783675791961
652,The Aviator,213719942,102610330,111109612,2004.csv,2004,0.4801158424420684,0.5198841575579316
653,"Crouching Tiger, Hidden Dragon",213525736,128078872,85446864,2000.csv,2000,0.5998287344622477,0.40017126553775234
654,Into the Woods,212902372,128002372,84900000,2014.csv,2014,0.6012256735213829,0.39877432647861716
655,Bedtime Stories,212874864,110101975,102772889,2008.csv,2008,0.5172145406514506,0.4827854593485495
656,Miss Congeniality,212742720,106807667,105935053,2000.csv,2000,0.502050866887478,0.49794913311252204
657,Entrapment,212404396,87704396,124700000,1999.csv,1999,0.41291233915893155,0.5870876608410684
658,End of Days,211989043,66889043,145100000,1999.csv,1999,0.3155306616483947,0.6844693383516053
659,Bridget Jones's Baby,211952420,24252420,187700000,2016.csv,2016,0.11442388815376583,0.8855761118462342
660,Battle Los Angeles,211819354,83552429,128266925,2011.csv,2011,0.3944513446113144,0.6055486553886856
661,Fury,211817906,85817906,126000000,2014.csv,2014,0.4051494400100433,0.5948505599899566
662,Australia,211787511,49554002,162233509,2008.csv,2008,0.23397981196351092,0.7660201880364891
663,Due Date,211780824,100539043,111241781,2010.csv,2010,0.47473156965335067,0.5252684303466493
664,Master and Commander: The Far Side of the World,211622535,93927920,117694615,2003.csv,2003,0.44384649300226936,0.5561535069977307
665,A Series of Unfortunate Events,211468235,118634549,92833686,2004.csv,2004,0.5610041101444858,0.43899588985551424
666,Nice View,211019042,0,211019042,2022.csv,2022,0.0,1.0
667,District 9,210888950,115646235,95242715,2009.csv,2009,0.5483750334002802,0.4516249665997199
668,The Others,209947037,96522687,113424350,2001.csv,2001,0.4597477934399236,0.5402522065600764
669,Horrible Bosses,209838559,117538559,92300000,2011.csv,2011,0.5601380392628411,0.4398619607371589
670,Us and Them,209221380,0,209221380,2018.csv,2018,0.0,1.0
671,Red Dragon,209196298,93149898,116046400,2002.csv,2002,0.44527507843374936,0.5547249215662506
672,Tomorrowland,209035668,93436322,115599346,2015.csv,2015,0.44698745861878464,0.5530125413812154
673,Me Before You,208314186,56245075,152069111,2016.csv,2016,0.2700011750519957,0.7299988249480043
674,Safe House,208076205,126373434,81702771,2012.csv,2012,0.6073420745058283,0.3926579254941717
675,S.W.A.T.,207725639,116934650,90790989,2003.csv,2003,0.562928344151104,0.43707165584889596
676,Traffic,207515725,124115725,83400000,2000.csv,2000,0.5981027461894756,0.4018972538105245
677,The Fast and the Furious,207283925,144533925,62750000,2001.csv,2001,0.697275126375574,0.302724873624426
678,Paranormal Activity 3,207039844,104028807,103011037,2011.csv,2011,0.5024579085366776,0.4975420914633224
679,Austin Powers: The Spy Who Shagged Me,206756056,206040086,715970,1999.csv,1999,0.996537126825441,0.003462873174558911
680,The Conjuring: The Devil Made Me Do It,206401480,65631050,140770430,2021.csv,2021,0.3179776133388191,0.6820223866611809
681,Sleepy Hollow,206071502,101071502,105000000,1999.csv,1999,0.4904681191676858,0.5095318808323143
682,Lightyear,205896879,113444297,92452582,2022.csv,2022,0.5509762826468099,0.4490237173531902
683,Raging Fire,205846481,385305,205461176,2021.csv,2021,0.0018718075632296089,0.9981281924367704
684,The Holiday,205841885,63224849,142617036,2006.csv,2006,0.3071524971703402,0.6928475028296598
685,London Has Fallen,205754447,62524260,143230187,2016.csv,2016,0.30387804935268303,0.696121950647317
686,The Break-Up,205668210,118703275,86964935,2006.csv,2006,0.5771590806376931,0.4228409193623069
687,Journey to the West,205637183,18058,205619125,2013.csv,2013,8.781485788005567e-05,0.99991218514212
688,White House Down,205366737,73103784,132262953,2013.csv,2013,0.35596701329485503,0.644032986705145
689,Birds of Prey,205308611,84158461,121150150,2020.csv,2020,0.40991198854294525,0.5900880114570548
690,The Ugly Truth,205298907,88915214,116383693,2009.csv,2009,0.43310125367593894,0.566898746324061
691,A Dog's Purpose,205035819,64508620,140527199,2017.csv,2017,0.3146212223533489,0.6853787776466511
692,Fun with Dick and Jane,204681899,110332737,94349162,2005.csv,2005,0.5390449157402043,0.46095508425979576
693,Eat Pray Love,204594016,80574010,124020006,2010.csv,2010,0.39382388388133505,0.606176116118665
694,You Don't Mess with the Zohan,204313400,100018837,104294563,2008.csv,2008,0.48953635444371246,0.5104636455562875
695,Ponyo,204171810,15090399,189081411,2008.csv,2008,0.07391029643122624,0.9260897035687737
696,King Arthur,203567857,51882244,151685613,2004.csv,2004,0.2548646174528428,0.7451353825471573
697,Hairspray,203552922,118871849,84681073,2007.csv,2007,0.5839849795916956,0.4160150204083044
698,Yogi Bear,203509374,100246011,103263363,2010.csv,2010,0.49258670020772605,0.5074132997922739
699,Everest,203427584,43482270,159945314,2015.csv,2015,0.2137481512831613,0.7862518487168387
700,Vanilla Sky,203388341,100618344,102769997,2001.csv,2001,0.4947104809709815,0.5052895190290185
701,Arrival,203388186,100546139,102842047,2016.csv,2016,0.49435584719753584,0.5056441528024641
702,Need for Speed,203277636,43577636,159700000,2014.csv,2014,0.2143749644943726,0.7856250355056273
703,Garfield,203172417,75369589,127802828,2004.csv,2004,0.3709636874576336,0.6290363125423665
704,The Addams Family,203044905,100044905,103000000,2019.csv,2019,0.49272305059809307,0.5072769494019069
705,Straight Outta Compton,201634991,161197785,40437206,2015.csv,2015,0.7994534291917617,0.20054657080823834
706,21 Jump Street,201585328,138447667,63137661,2012.csv,2012,0.6867943633278708,0.31320563667212925
707,Valkyrie,201545517,83077833,118467684,2008.csv,2008,0.41220382490571594,0.5877961750942841
708,Open Season,200811689,85105259,115706430,2006.csv,2006,0.4238063004390148,0.5761936995609852
709,Cats & Dogs,200687492,93385515,107301977,2001.csv,2001,0.46532802851510047,0.5346719714848995
710,Percy Jackson: Sea of Monsters,199850315,68559554,131290761,2013.csv,2013,0.34305452057956476,0.6569454794204352
711,Two Weeks Notice,199043242,93354851,105688391,2002.csv,2002,0.469017938323171,0.530982061676829
712,RED,199006387,90380162,108626225,2010.csv,2010,0.45415709195303366,0.5458429080469663
713,Shock Wave 2,198921659,0,198921659,2020.csv,2020,0.0,1.0
714,The Pacifier,198636868,113086868,85550000,2005.csv,2005,0.5693145947105851,0.43068540528941485
715,Total Recall,198467168,58877969,139589199,2012.csv,2012,0.296663521696445,0.703336478303555
716,50 First Dates,198413428,120908074,77505354,2004.csv,2004,0.6093744522170143,0.39062554778298575
717,The Island,198326350,670883,197655467,2018.csv,2018,0.0033827224672868736,0.9966172775327131
718,The Impossible,198087212,19019882,179067330,2012.csv,2012,0.09601771769093302,0.903982282309067
719,Lost in Thailand,197757387,57387,197700000,2012.csv,2012,0.00029018890707733716,0.9997098110929227
720,Christopher Robin,197744377,99215042,98529335,2018.csv,2018,0.5017338217409844,0.4982661782590157
721,Jack the Giant Slayer,197687603,65187603,132500000,2013.csv,2013,0.3297505863329225,0.6702494136670776
722,Ghostbusters: Afterlife,197360575,129360575,68000000,2021.csv,2021,0.655452969773725,0.3445470302262749
723,Smurfs: The Lost Village,197183546,45020282,152163264,2017.csv,2017,0.22831662637814618,0.7716833736218538
724,Chinese Doctors,197143218,0,197143218,2021.csv,2021,0.0,1.0
725,Spy Kids 3: Game Over,197011982,111761982,85250000,2003.csv,2003,0.567285201973147,0.43271479802685303
726,The Other Woman,196710396,83911193,112799203,2014.csv,2014,0.4265722336301941,0.5734277663698059
727,Panic Room,196397415,96397334,100000081,2002.csv,2002,0.49082791644686363,0.5091720835531364
728,Beowulf,196393745,82280579,114113166,2007.csv,2007,0.41895722799114604,0.5810427720088539
729,The Vow,196114570,125014030,71100540,2012.csv,2012,0.6374540657535032,0.36254593424649684
730,Anger Management,195745823,135645823,60100000,2003.csv,2003,0.6929691827957933,0.3070308172042067
731,Tropic Thunder,195702811,110515313,85187498,2008.csv,2008,0.564709890651494,0.435290109348506
732,The Shape of Water,195333312,63859435,131473877,2017.csv,2017,0.3269254708587545,0.6730745291412455
733,Rocketman,195320400,96368160,98952240,2019.csv,2019,0.4933850227625993,0.5066149772374007
734,The BFG,195243411,55483770,139759641,2016.csv,2016,0.28417742609506036,0.7158225739049396
735,The Intern,194564672,75764672,118800000,2015.csv,2015,0.38940610965591943,0.6105938903440805
736,Wallace & Gromit: The Curse of the Were-Rabbit,194111171,56110897,138000274,2005.csv,2005,0.2890657797329964,0.7109342202670036
737,Gnomeo & Juliet,193967670,99967670,94000000,2011.csv,2011,0.5153831563785862,0.48461684362141383
738,Weathering with You,193932489,8056636,185875853,2019.csv,2019,0.04154350847319863,0.9584564915268013
739,The Sum of All Fears,193921372,118907036,75014336,2002.csv,2002,0.6131713837090633,0.38682861629093673
740,Gangs of New York,193772504,77812000,115960504,2002.csv,2002,0.4015636810886234,0.5984363189113766
741,The Monkey King 2,193678298,709982,192968316,2016.csv,2016,0.003665779838689,0.996334220161311
742,Paranormal Activity,193355800,107918810,85436990,2009.csv,2009,0.5581358821405926,0.4418641178594074
743,The Equalizer,192330738,101530738,90800000,2014.csv,2014,0.527896575741315,0.47210342425868507
744,The Lego Movie 2: The Second Part,192306508,105806508,86500000,2019.csv,2019,0.5501972299346208,0.44980277006537916
745,Downton Abbey,192199131,96853865,95345266,2019.csv,2019,0.5039245728951813,0.4960754271048187
746,Sheep Without a Shepherd,191602146,0,191602146,2019.csv,2019,0.0,1.0
747,The Longest Yard,191466556,158119460,33347096,2005.csv,2005,0.8258333115888918,0.17416668841110822
748,The Lost City,190844029,105344029,85500000,2022.csv,2022,0.5519901751812208,0.4480098248187791
749,The Equalizer 2,190400157,102084362,88315795,2018.csv,2018,0.5361569213411941,0.4638430786588059
750,Hollow Man,190213455,73209340,117004115,2000.csv,2000,0.3848799234523131,0.615120076547687
751,Cheaper by the Dozen,190212113,138614544,51597569,2003.csv,2003,0.7287366814541406,0.2712633185458594
752,The White Storm 2: Drug Lords,189396380,609461,188786919,2019.csv,2019,0.003217912612690908,0.9967820873873091
753,Breakup Buddies,189017596,777896,188239700,2014.csv,2014,0.004115468699538428,0.9958845313004616
754,The Secret Life of Walter Mitty,188133322,58236838,129896484,2013.csv,2013,0.30955089391341317,0.6904491060865868
755,Project Gutenberg,188116796,0,188116796,2018.csv,2018,0.0,1.0
756,12 Years a Slave,187733202,56671993,131061209,2013.csv,2013,0.30187517389704993,0.6981248261029501
757,Mr. Popper's Penguins,187361754,68224452,119137302,2011.csv,2011,0.3641322230576471,0.635867776942353
758,The Grudge,187281115,110359362,76921753,2004.csv,2004,0.5892711713084365,0.41072882869156346
759,I Now Pronounce You Chuck & Larry,187134117,120059556,67074561,2007.csv,2007,0.6415695754719061,0.3584304245280939
760,Walk the Line,186797986,119519402,67278584,2005.csv,2005,0.6398323909123945,0.3601676090876055
761,Jian Bing Man,186683536,0,186683536,2015.csv,2015,0.0,1.0
762,The Final Destination,186167139,66477700,119689439,2009.csv,2009,0.35708611281822406,0.6429138871817759
763,Atlantis: The Lost Empire,186053725,84056472,101997253,2001.csv,2001,0.45178602040888993,0.5482139795911101
764,Inside Man,186003591,88513495,97490096,2006.csv,2006,0.47586981801872846,0.5241301819812715
765,Hugo,185770160,73864507,111905653,2011.csv,2011,0.39761233451055866,0.6023876654894413
766,The Lion King 2011 3D Release,185542001,94242001,91300000,2011.csv,2011,0.5079281267425805,0.49207187325741947
767,Pitch Perfect 3,185400345,104897530,80502815,2017.csv,2017,0.5657892923554161,0.4342107076445839
768,Watchmen,185382813,107509799,77873014,2009.csv,2009,0.5799340147028624,0.42006598529713757
769,Hop,183953723,108085305,75868418,2011.csv,2011,0.5875679123928359,0.4124320876071641
770,Bad Moms,183936074,113257297,70678777,2016.csv,2016,0.615742711785835,0.3842572882141651
771,Jupiter Ascending,183887723,47387723,136500000,2015.csv,2015,0.25769922117095334,0.7423007788290467
772,Knowing,183658498,79957634,103700864,2007.csv,2007,0.435360382834014,0.564639617165986
773,102 Dalmatians,183611771,66957026,116654745,2000.csv,2000,0.36466630453665194,0.6353336954633481
774,Stand by Me Doraemon,183442714,0,183442714,2014.csv,2014,0.0,1.0
775,Storks,183388953,72679278,110709675,2016.csv,2016,0.3963121922616571,0.6036878077383429
776,Paul Blart: Mall Cop,183348429,146336178,37012251,2009.csv,2009,0.7981316163881611,0.20186838361183884
777,Mirror Mirror,183018522,64935167,118083355,2012.csv,2012,0.3548010676209045,0.6451989323790955
778,The Haunted Mansion,182290266,75847266,106443000,2003.csv,2003,0.41607962764177436,0.5839203723582257
779,From Vegas to Macau III,181732879,0,181732879,2016.csv,2016,0.0,1.0
780,Poseidon,181674817,60674817,121000000,2006.csv,2006,0.33397483482809837,0.6660251651719016
781,Cliff Walkers,181325565,152972,181172593,2021.csv,2021,0.0008436317294806168,0.9991563682705193
782,Scooby-Doo 2: Monsters Unleashed,181216833,84216833,97000000,2004.csv,2004,0.46472963689857666,0.5352703631014234
783,Road to Perdition,181001478,104454762,76546716,2002.csv,2002,0.5770934201984804,0.42290657980151963
784,Kill Bill: Vol. 1,180899045,70099045,110800000,2003.csv,2003,0.38750367642902706,0.612496323570973
785,Sweet Home Alabama,180622424,127223418,53399006,2002.csv,2002,0.7043611484252918,0.29563885157470815
786,Daddy's Home 2,180613180,104029443,76583737,2017.csv,2017,0.5759792447040687,0.42402075529593136
787,Hacksaw Ridge,180563636,67209615,113354021,2016.csv,2016,0.37222120959061766,0.6277787904093823
788,Deja Vu,180557550,64038616,116518934,2006.csv,2006,0.35467149393642083,0.6453285060635792
789,The Post,179769457,81903458,97865999,2017.csv,2017,0.4556027445752367,0.5443972554247632
790,The Dictator,179379533,59650222,119729311,2012.csv,2012,0.3325363880839181,0.6674636119160818
791,The League of Extraordinary Gentlemen,179265204,66465204,112800000,2003.csv,2003,0.37076466886457227,0.6292353311354277
792,Allegiant,179246868,66184051,113062817,2016.csv,2016,0.36923407219589466,0.6307659278041053
793,Moulin Rouge!,179213434,57386607,121826827,2001.csv,2001,0.320213756966456,0.6797862430335441
794,Daredevil,179179718,102543518,76636200,2003.csv,2003,0.5722942258453605,0.4277057741546395
795,Abominable,179053956,60716390,118337566,2019.csv,2019,0.33909549588505045,0.6609045041149496
796,He's Just Not That Into You,178866158,93953653,84912505,2009.csv,2009,0.5252735008709697,0.4747264991290303
797,The Scorpion King,178799308,91047077,87752231,2002.csv,2002,0.5092138108275005,0.4907861891724995
798,Eagle Eye,178767383,101440743,77326640,2008.csv,2008,0.5674454774560301,0.43255452254396987
799,Along Came Polly,178311729,88097164,90214565,2004.csv,2004,0.4940626423963395,0.5059373576036605
800,Flushed Away,178281554,64665672,113615882,2006.csv,2006,0.36271656012152553,0.6372834398784745
801,Scary Movie 4,178262620,90710620,87552000,2006.csv,2006,0.5088594569068939,0.4911405430931061
802,Brokeback Mountain,178062759,83043761,95018998,2005.csv,2005,0.46637354978870116,0.5336264502112988
803,Baywatch,177856751,58060186,119796565,2017.csv,2017,0.32644353207599075,0.6735564679240093
804,Double Jeopardy,177841558,116741558,61100000,1999.csv,1999,0.6564357583956839,0.34356424160431615
805,War Horse,177584879,79884879,97700000,2011.csv,2011,0.44984054639021376,0.5501594536097862
806,Paranormal Activity 2,177512032,84752907,92759125,2010.csv,2010,0.4774488018930458,0.5225511981069543
807,How to Lose a Guy in 10 Days,177502387,105813373,71689014,2003.csv,2003,0.5961236622693981,0.4038763377306019
808,Alien vs. Predator,177427090,80282231,97144859,2004.csv,2004,0.4524801201439983,0.5475198798560017
809,Hero,177395557,53710019,123685538,2002.csv,2002,0.302769809505432,0.697230190494568
810,The 40-Year-Old Virgin,177378645,109449237,67929408,2005.csv,2005,0.6170372820245639,0.38296271797543613
811,Lee Daniels' The Butler,177313795,116632095,60681700,2013.csv,2013,0.6577722562421046,0.34222774375789544
812,The Haunting,177311151,91411151,85900000,1999.csv,1999,0.5155409035723872,0.4844590964276127
813,The Descendants,177243185,82584160,94659025,2011.csv,2011,0.4659370119082435,0.5340629880917566
814,The A-Team,177238796,77222099,100016697,2010.csv,2010,0.4356952357090036,0.5643047642909964
815,Analyze This,176885658,106885658,70000000,1999.csv,1999,0.6042641286383998,0.39573587136160016
816,The Hitman's Bodyguard,176586701,75468583,101118118,2017.csv,2017,0.4273741033306919,0.5726258966693081
817,Looper,176506819,66486205,110020614,2012.csv,2012,0.37667782682095696,0.623322173179043
818,Serial (Bad) Weddings,176404493,0,176404493,2014.csv,2014,0.0,1.0
819,Ip Man 4: The Finale,176345966,3956031,172389935,2019.csv,2019,0.02243335126815433,0.9775666487318456
820,Dr. Dolittle 2,176104344,112952899,63151445,2001.csv,2001,0.6413975739292382,0.35860242607076176
821,The Italian Job,176070171,106128601,69941570,2003.csv,2003,0.6027630938121824,0.3972369061878176
822,The Monkey King Havoc in Heavens Palace,175835580,0,175835580,2014.csv,2014,0.0,1.0
823,The Bucket List,175372502,93466502,81906000,2007.csv,2007,0.5329598479469717,0.46704015205302823
824,Cowboys & Aliens,174822325,100240551,74581774,2011.csv,2011,0.5733852984737504,0.4266147015262496
825,The Mule,174804407,103804407,71000000,2018.csv,2018,0.5938317504775494,0.40616824952245056
826,Evan Almighty,174440724,100462298,73978426,2007.csv,2007,0.5759108062404052,0.4240891937595948
827,Identity Thief,173965010,134506920,39458090,2013.csv,2013,0.7731837568945618,0.22681624310543827
828,The Nutcracker and the Four Realms,173961069,54858851,119102218,2018.csv,2018,0.3153513100106323,0.6846486899893677
829,Big Momma's House,173959438,117559438,56400000,2000.csv,2000,0.6757864899517553,0.32421351004824467
830,In Time,173930596,37520095,136410501,2011.csv,2011,0.215718774401256,0.784281225598744
831,Amélie,173921954,33225499,140696455,2001.csv,2001,0.1910368313824257,0.8089631686175743
832,Operation Mekong,173839072,800012,173039060,2016.csv,2016,0.004602026407504062,0.9953979735924959
833,Creed,173567581,109767581,63800000,2015.csv,2015,0.6324198353608442,0.3675801646391557
834,Gemini Man,173469516,48546770,124922746,2019.csv,2019,0.27985764369112553,0.7201423563088745
835,The Girl on the Train,173185859,75395035,97790824,2016.csv,2016,0.435341750390833,0.564658249609167
836,Cold Mountain,173013509,95636509,77377000,2003.csv,2003,0.5527690268394013,0.4472309731605987
837,Black Hawk Down,172989651,108638745,64350906,2001.csv,2001,0.6280071921759065,0.3719928078240935
838,The Grand Budapest Hotel,172936941,59301324,113635617,2014.csv,2014,0.342907210322403,0.657092789677597
839,The Santa Clause 2,172855065,139236327,33618738,2002.csv,2002,0.8055090951485859,0.1944909048514141
840,Cloverfield,172394180,80048433,92345747,2008.csv,2008,0.46433373214803425,0.5356662678519658
841,Couples Retreat,171844840,109204945,62639895,2009.csv,2009,0.6354857381810243,0.3645142618189758
842,Blood Diamond,171720398,57377916,114342482,2006.csv,2006,0.3341357035522361,0.6658642964477639
843,Jackass 3D,171685792,117229692,54456100,2010.csv,2010,0.6828153374508708,0.3171846625491293
844,No Country for Old Men,171627166,74283625,97343541,2007.csv,2007,0.43281973787296585,0.5671802621270341
845,Spies in Disguise,171616764,66757013,104859751,2019.csv,2019,0.3889888810629246,0.6110111189370754
846,John Wick: Chapter 2,171539887,92029184,79510703,2017.csv,2017,0.5364885427492441,0.46351145725075593
847,Anchorman 2: The Legend Continues,171464676,125168368,46296308,2013.csv,2013,0.7299950690718361,0.2700049309281639
848,Mr. Deeds,171269535,126293452,44976083,2002.csv,2002,0.7373958947223159,0.2626041052776841
849,Superbad,170812526,121463226,49349300,2007.csv,2007,0.7110908599290897,0.28890914007091023
850,Chinese Zodiac,170525083,0,170525083,2012.csv,2012,0.0,1.0
851,The Other Guys,170458922,119219978,51238944,2010.csv,2010,0.6994059131736149,0.30059408682638505
852,Olympus Has Fallen,170270201,98925640,71344561,2013.csv,2013,0.5809920903305916,0.4190079096694083
853,Starsky & Hutch,170268750,88237754,82030996,2004.csv,2004,0.5182263568623132,0.4817736431376867
854,Shall We Dance,170128460,57890460,112238000,2004.csv,2004,0.3402749898517861,0.6597250101482138
855,Stuart Little 2,169956806,64956806,105000000,2002.csv,2002,0.3821959680743824,0.6178040319256176
856,Zookeeper,169852759,80360843,89491916,2011.csv,2011,0.47312062207950356,0.5268793779204964
857,Dumb and Dumber To,169837010,86208010,83629000,2014.csv,2014,0.5075926030492411,0.49240739695075886
858,Ghost in the Shell,169801921,40563557,129238364,2017.csv,2017,0.23888750351652382,0.7611124964834762
859,Seven Pounds,169748929,69951824,99797105,2008.csv,2008,0.412089928414217,0.587910071585783
860,Wonder Woman 1984,169602006,46801036,122800970,2020.csv,2020,0.2759462408717029,0.7240537591282971
861,Meet the Robinsons,169333034,97822171,71510863,2007.csv,2007,0.5776910074144186,0.42230899258558136
862,The Emperor's New Groove,169327687,89302687,80025000,2000.csv,2000,0.5273956585729539,0.4726043414270461
863,The Suicide Squad,168657565,55817425,112840140,2021.csv,2021,0.33095120874062184,0.6690487912593781
864,Dodgeball: A True Underdog Story,168423227,114326736,54096491,2004.csv,2004,0.6788062313994256,0.3211937686005743
865,Hellboy II: The Golden Army,168319243,75986503,92332740,2008.csv,2008,0.4514427563104,0.5485572436896
866,Insidious: The Last Key,167885588,67745330,100140258,2018.csv,2018,0.40352081919026905,0.596479180809731
867,Fantastic Four,167882881,56117548,111765333,2015.csv,2015,0.3342660530110869,0.6657339469889131
868,Unstoppable,167805466,81562942,86242524,2010.csv,2010,0.48605652690717477,0.5139434730928253
869,Magic Mike,167739368,113721571,54017797,2012.csv,2012,0.6779658964733908,0.3220341035266092
870,Alexander,167298192,34297191,133001001,2004.csv,2004,0.20500634579481888,0.7949936542051811
871,Up in the Air,166842739,83823381,83019358,2009.csv,2009,0.5024095234974535,0.4975904765025465
872,Nutty Professor II: The Klumps,166339890,123309890,43030000,2000.csv,2000,0.7413128023590734,0.2586871976409267
873,Bridge of Spies,165478348,72313754,93164594,2015.csv,2015,0.4369982833041094,0.5630017166958906
874,The Princess Diaries,165335153,108248956,57086197,2001.csv,2001,0.6547243827814403,0.3452756172185597
875,The Muppets,165184237,88631237,76553000,2011.csv,2011,0.5365598958452676,0.4634401041547324
876,The Huntsman: Winter's War,164989338,48390190,116599148,2016.csv,2016,0.2932928308373478,0.7067071691626522
877,Saw III,164874275,80238724,84635551,2006.csv,2006,0.4866661218070557,0.5133338781929443
878,Bringing Down the House,164729679,132716677,32013002,2003.csv,2003,0.8056634226792854,0.19433657732071463
879,Deep Blue Sea,164648142,73648142,91000000,1999.csv,1999,0.4473062441239088,0.5526937558760913
880,Daddy Day Care,164433867,104297061,60136806,2003.csv,2003,0.6342796827857853,0.3657203172142148
881,The Spiderwick Chronicles,164170327,71195053,92975274,2008.csv,2008,0.43366578054023125,0.5663342194597688
882,The Pink Panther,164115897,82226474,81889423,2006.csv,2006,0.5010268688352597,0.49897313116474024
883,Four Christmases,164112721,120146040,43966681,2008.csv,2008,0.7320946192830475,0.26790538071695247
884,The Ring Two,163995949,76231249,87764700,2005.csv,2005,0.46483617104468844,0.5351638289553116
885,From Vegas to Macau II,163877532,0,163877532,2015.csv,2015,0.0,1.0
886,Morbius,163865530,73865530,90000000,2022.csv,2022,0.45076917640946207,0.5492308235905379
887,Miami Vice,163794509,63450470,100344039,2006.csv,2006,0.38737849264531815,0.6126215073546818
888,Space Jam: A New Legacy,163732928,70592228,93140700,2021.csv,2021,0.43114252497823774,0.5688574750217623
889,Burn After Reading,163728902,60355347,103373555,2008.csv,2008,0.3686297670279374,0.6313702329720625
890,Pokémon: The First Movie - Mewtwo Strikes Back,163644662,85744662,77900000,1999.csv,1999,0.5239685850553438,0.4760314149446561
891,The Happening,163403799,64506874,98896925,2008.csv,2008,0.3947697323732357,0.6052302676267644
892,Talladega Nights: The Ballad of Ricky Bobby,163362095,148213377,15148718,2006.csv,2006,0.9072690760974876,0.09273092390251239
893,World Trade Center,163247198,70278893,92968305,2006.csv,2006,0.43050596801055047,0.5694940319894495
894,The Island,162949164,35818913,127130251,2005.csv,2005,0.21981648828833514,0.7801835117116649
895,The Interpreter,162944923,72708161,90236762,2005.csv,2005,0.4462131109172392,0.5537868890827609
896,27 Dresses,162655351,76808654,85846697,2008.csv,2008,0.47221719745328267,0.5277828025467173
897,The Magnificent Seven,162360636,93432655,68927981,2016.csv,2016,0.5754637164638847,0.4245362835361152
898,Memoirs of a Geisha,162242962,57490508,104752454,2005.csv,2005,0.35434823977141144,0.6456517602285885
899,Jack Reacher: Never Go Back,162146076,58697076,103449000,2016.csv,2016,0.36200121179620776,0.6379987882037922
900,Eyes Wide Shut,162091208,55691208,106400000,1999.csv,1999,0.3435794494171454,0.6564205505828545
901,Insidious: Chapter 2,161919318,83586447,78332871,2013.csv,2013,0.5162228203060983,0.4837771796939016
902,Limitless,161849455,79249455,82600000,2011.csv,2011,0.489649192825518,0.510350807174482
903,Scream 3,161834276,89143175,72691101,2000.csv,2000,0.5508300046400554,0.4491699953599446
904,Flight,161772375,93772375,68000000,2012.csv,2012,0.5796562917494411,0.42034370825055883
905,Payback,161626121,81526121,80100000,1999.csv,1999,0.5044117899729834,0.4955882100270166
906,Jujutsu Kaisen 0: The Movie,161580222,29693448,131886774,2021.csv,2021,0.18376907540082474,0.8162309245991752
907,Into the Storm,161502194,47602194,113900000,2014.csv,2014,0.29474642307336085,0.7052535769266391
908,Unbroken,161459297,115637895,45821402,2014.csv,2014,0.7162046233856698,0.28379537661433024
909,The Sacrifice,161047608,0,161047608,2020.csv,2020,0.0,1.0
910,Freaky Friday,160846332,110230332,50616000,2003.csv,2003,0.6853145522771387,0.31468544772286133
911,The Predator,160542134,51024708,109517426,2018.csv,2018,0.3178275181018835,0.6821724818981165
912,Johnny English,160466000,28082366,132383634,2003.csv,2003,0.1750050851893859,0.824994914810614
913,"Three Billboards Outside Ebbing, Missouri",160192031,54513740,105678291,2017.csv,2017,0.3403024461310438,0.6596975538689562
914,Underworld: Awakening,160112671,62321039,97791632,2012.csv,2012,0.3892323987275186,0.6107676012724814
915,Lara Croft Tomb Raider: The Cradle of Life,160099222,65660196,94439026,2003.csv,2003,0.41012189303455826,0.5898781069654417
916,Johnny English Reborn,160078586,8305970,151772616,2011.csv,2011,0.051886827636021225,0.9481131723639787
917,Norbit,159814490,95673607,64140883,2007.csv,2007,0.5986541458161898,0.40134585418381025
918,21,159808370,81159365,78649005,2008.csv,2008,0.5078542819753433,0.4921457180246567
919,Elvis,159430167,95230167,64200000,2022.csv,2022,0.5973158580458615,0.40268414195413843
920,Princess Mononoke,159414369,2375308,157039061,1999.csv,1999,0.014900212665271096,0.9850997873347289
921,Step Up 3D,159291809,42400223,116891586,2010.csv,2010,0.26617955603731014,0.7338204439626899
922,Happy Feet Two,159196259,64006466,95189793,2011.csv,2011,0.4020601137367179,0.5979398862632821
923,Johnny English Strikes Again,158970776,4412170,154558606,2018.csv,2018,0.02775459811556811,0.9722454018844319
924,The Fast and the Furious: Tokyo Drift,158964610,62514415,96450195,2006.csv,2006,0.3932599526397731,0.6067400473602269
925,Focus,158762963,53862963,104900000,2015.csv,2015,0.3392665517334795,0.6607334482665205
926,Sin City,158733820,74103820,84630000,2005.csv,2005,0.4668432977924931,0.5331567022075069
927,Goosebumps,158260952,80080379,78180573,2015.csv,2015,0.5060021312142745,0.4939978687857255
928,Final Destination 5,157887643,42587643,115300000,2011.csv,2011,0.26973385751283907,0.7302661424871609
929,Don't Breathe,157761002,89217875,68543127,2016.csv,2016,0.5655255346311758,0.43447446536882417
930,Hustlers,157563598,104963598,52600000,2019.csv,2019,0.6661665469203109,0.33383345307968915
931,The Matrix Resurrections,157297525,37686805,119610720,2021.csv,2021,0.2395893069519053,0.7604106930480947
932,The Book of Eli,157107755,94835059,62272696,2010.csv,2010,0.6036306673722122,0.39636933262778784
933,Ip Man 3,156954938,2679437,154275501,2015.csv,2015,0.01707137751855886,0.9829286224814411
934,The Climbers,156892866,487157,156405709,2019.csv,2019,0.0031050296448788183,0.9968949703551212
935,P.S. I Love You,156835339,53695808,103139531,2007.csv,2007,0.3423705928929704,0.6576294071070297
936,Mystic River,156595191,90135191,66460000,2003.csv,2003,0.5755936081076717,0.4244063918923283
937,This Means War,156491279,54760791,101730488,2012.csv,2012,0.3499287075288074,0.6500712924711926
938,Rocky Balboa,155929020,70270943,85658077,2006.csv,2006,0.45065981303544395,0.549340186964556
939,The Hateful Eight,155760117,54117416,101642701,2015.csv,2015,0.3474407765114866,0.6525592234885135
940,Escape Room,155712077,57005601,98706476,2019.csv,2019,0.36609620845273294,0.6339037915472671
941,The Monuments Men,155641650,78031620,77610030,2014.csv,2014,0.5013543611237737,0.49864563887622626
942,The Mummy,155563437,155385488,177949,1999.csv,1999,0.9988561001001797,0.00114389989982029
943,Hannah Montana: The Movie,155545279,79576189,75969090,2009.csv,2009,0.5115950127936701,0.4884049872063298
944,Monster-in-Law,155457327,82931301,72526026,2005.csv,2005,0.5334666599535705,0.4665333400464296
945,Dreamgirls,155430335,103365956,52064379,2006.csv,2006,0.6650307740763732,0.3349692259236268
946,The Accountant,155160045,86260045,68900000,2016.csv,2016,0.5559423819450426,0.44405761805495736
947,Bayside Shakedown 2,155138312,0,155138312,2003.csv,2003,0.0,1.0
948,Blade II,155010032,82348319,72661713,2002.csv,2002,0.5312450938659248,0.4687549061340752
949,Maid in Manhattan,154906693,94011225,60895468,2002.csv,2002,0.6068893679113013,0.39311063208869873
950,Lone Survivor,154802912,125095601,29707311,2013.csv,2013,0.8080959161801814,0.19190408381981858
951,The Phantom of the Opera,154648887,51268815,103380072,2004.csv,2004,0.331517516837997,0.668482483162003
952,Yesterday,154608507,73286650,81321857,2019.csv,2019,0.47401434385496005,0.5259856561450399
953,Ride Along,154468902,134938200,19530702,2014.csv,2014,0.8735622397315933,0.12643776026840664
954,Kill Bill: Vol. 2,154116796,66208183,87908613,2004.csv,2004,0.4295974528305143,0.5704025471694857
955,The Town,154026136,92186262,61839874,2010.csv,2010,0.598510515124524,0.4014894848754759
956,House of Gucci,153939176,53809574,100129602,2021.csv,2021,0.34955087715943084,0.6504491228405692
957,Peter Rabbit 2: The Runaway,153901717,40501717,113400000,2021.csv,2021,0.2631661152942173,0.7368338847057827
958,Sweeney Todd: The Demon Barber of Fleet Street,153383627,52898073,100485554,2007.csv,2007,0.34487431308427724,0.6551256869157227
959,Monkey King: Hero Is Back,153262397,0,153262397,2015.csv,2015,0.0,1.0
960,Tower Heist,152930623,78046570,74884053,2011.csv,2011,0.5103397113604906,0.48966028863950944
961,Duckweed,152894264,471575,152422689,2017.csv,2017,0.0030843210704098096,0.9969156789295902
962,Chocolat,152699946,71509363,81190583,2000.csv,2000,0.4682998578139641,0.5317001421860359
963,Date Night,152263880,98711404,53552476,2010.csv,2010,0.6482916631311378,0.35170833686886216
964,Vantage Point,152039882,72266306,79773576,2008.csv,2008,0.4753115106995413,0.5246884893004586
965,Surf's Up,152005713,58867694,93138019,2007.csv,2007,0.3872729046703659,0.6127270953296341
966,Jackass Presents: Bad Grandpa,151826547,102003019,49823528,2013.csv,2013,0.6718391547164674,0.3281608452835327
967,47 Ronin,151783839,38362475,113421364,2013.csv,2013,0.25274413437388416,0.7472558656261158
968,Midnight in Paris,151672318,56817045,94855273,2011.csv,2011,0.3746039208024763,0.6253960791975237
969,Red Sparrow,151572634,46874505,104698129,2018.csv,2018,0.30925440670246584,0.6907455932975342
970,The Bone Collector,151493655,66518655,84975000,1999.csv,1999,0.43908541912200877,0.5609145808779912
971,Darkest Hour,150847207,56468410,94378797,2017.csv,2017,0.37434176689794463,0.6256582331020554
972,Step Up 2: The Streets,150816700,58017783,92798917,2008.csv,2008,0.3846907073288303,0.6153092926711697
973,Gods of Egypt,150680864,31153464,119527400,2015.csv,2015,0.20675129656808977,0.7932487034319102
974,The Taking of Pelham 1 2 3,150166126,65452312,84713814,2009.csv,2009,0.4358660221413716,0.5641339778586284
975,A Writer's Odyssey,150123320,160013,149963307,2021.csv,2021,0.001065877040289277,0.9989341229597107
976,I Am Number Four,149878437,55100437,94778000,2011.csv,2011,0.36763418476268206,0.6323658152373179
977,The General's Daughter,149705852,102705852,47000000,1999.csv,1999,0.6860510168967877,0.3139489831032123
978,Jack and Jill,149673788,74158157,75515631,2011.csv,2011,0.49546522467915355,0.5045347753208465
979,Friends with Benefits,149542245,55802754,93739491,2011.csv,2011,0.37315712359407205,0.626842876405928
980,Beverly Hills Chihuahua,149292488,94514402,54778086,2008.csv,2008,0.633082101224008,0.366917898775992
981,"Me, Myself & Irene",149270999,90570999,58700000,2000.csv,2000,0.606755495754403,0.393244504245597
982,No Strings Attached,149228077,70662220,78565857,2011.csv,2011,0.473518264260686,0.526481735739314
983,Charlotte's Web,148963822,82985708,65978114,2006.csv,2006,0.5570863239532079,0.4429136760467921
984,Lights Out,148868835,67268835,81600000,2016.csv,2016,0.4518664702387172,0.5481335297612828
985,The Secret World of Arrietty,148800274,19202743,129597531,2010.csv,2010,0.12905045457107156,0.8709495454289284
986,King Arthur: Legend of the Sword,148675066,39175066,109500000,2017.csv,2017,0.2634945257061463,0.7365054742938537
987,Seabiscuit,148336445,120277854,28058591,2003.csv,2003,0.8108449275564074,0.18915507244359267
988,RED 2,148075565,53262560,94813005,2013.csv,2013,0.35969850933879605,0.640301490661204
989,Spy Kids,147934180,112719001,35215179,2001.csv,2001,0.7619537351002993,0.23804626489970065
990,The Game Plan,147880543,90648202,57232341,2007.csv,2007,0.6129826152991608,0.38701738470083924
991,The Mexican,147845033,66845033,81000000,2001.csv,2001,0.4521290410885836,0.5478709589114164
992,The Angry Birds Movie 2,147792047,41667116,106124931,2019.csv,2019,0.2819307049722371,0.7180692950277628
993,Saw II,147748505,87039965,60708540,2005.csv,2005,0.5891089388687892,0.41089106113121077
994,Resident Evil: Extinction,147717833,50648679,97069154,2007.csv,2007,0.3428745058831184,0.6571254941168816
995,Arthur Christmas,147419472,46462469,100957003,2011.csv,2011,0.31517185870805453,0.6848281412919455
996,Source Code,147332697,54712227,92620470,2011.csv,2011,0.3713515608826464,0.6286484391173536
997,Swordfish,147080413,69772969,77307444,2001.csv,2001,0.4743865452703073,0.5256134547296927
998,Planes: Fire & Rescue,146965787,59165787,87800000,2014.csv,2014,0.402582044486313,0.597417955513687
999,The Last Witch Hunter,146936910,27367660,119569250,2015.csv,2015,0.18625449521158435,0.8137455047884157
1000,The Boss Baby 2: Family Business,146745280,57300280,89445000,2021.csv,2021,0.3904744329766518,0.6095255670233483
1001,Angel Has Fallen,146661977,69030436,77631541,2019.csv,2019,0.470677113537069,0.529322886462931
1002,Mama,146428180,71628180,74800000,2013.csv,2013,0.4891693661698179,0.5108306338301821
1003,Music and Lyrics,145896422,50572589,95323833,2007.csv,2007,0.3466335109986453,0.6533664890013546
1004,Time Raiders,145819137,0,145819137,2016.csv,2016,0.0,1.0
1005,Blades of Glory,145710347,118594548,27115799,2007.csv,2007,0.8139061531436749,0.18609384685632518
1006,The Foreigner,145374099,34393507,110980592,2017.csv,2017,0.23658620921186244,0.7634137907881375
1007,Home on the Range,145358062,50030461,95327601,2004.csv,2004,0.344187727268956,0.655812272731044
1008,The Exorcism of Emily Rose,145166804,75072454,70094350,2005.csv,2005,0.5171461514024929,0.4828538485975072
1009,"Crazy, Stupid, Love.",145051197,84351197,60700000,2011.csv,2011,0.5815270659227997,0.4184729340772003
1010,PAW Patrol: The Movie,144327371,40127371,104200000,2021.csv,2021,0.27803022200134164,0.7219697779986584
1011,Herbie Fully Loaded,144146816,66023816,78123000,2005.csv,2005,0.4580317334237893,0.5419682665762108
1012,The Beach,144056873,39785027,104271846,2000.csv,2000,0.2761758336931276,0.7238241663068724
1013,Pete's Dragon,143695338,76233151,67462187,2016.csv,2016,0.5305193060612725,0.4694806939387275
1014,Garfield: A Tail of Two Kitties,143325970,28426747,114899223,2006.csv,2006,0.19833633081290153,0.8016636691870985
1015,The Invisible Man,143151000,70410000,72741000,2020.csv,2020,0.49185824758471824,0.5081417524152818
1016,Spy Game,143049560,62362560,80687000,2001.csv,2001,0.435950729243767,0.564049270756233
1017,More Than Blue,142958164,722669,142235495,2018.csv,2018,0.005055108290282743,0.9949448917097172
1018,Paranormal Activity 4,142802657,53885000,88917657,2012.csv,2012,0.3773389174404507,0.6226610825595493
1019,The Legend of Zorro,142400065,46464023,95936042,2005.csv,2005,0.32629214740878104,0.673707852591219
1020,Power Rangers,142337240,85364450,56972790,2017.csv,2017,0.5997337731151735,0.4002662268848265
1021,New Year's Eve,142044638,54544638,87500000,2011.csv,2011,0.3839964589159641,0.6160035410840359
1022,Onward,141940042,61555145,80384897,2020.csv,2020,0.43367004921697855,0.5663299507830215
1023,Monster House,141861243,73661010,68200233,2006.csv,2006,0.519246895362393,0.48075310463760706
1024,Legally Blonde,141774679,96520674,45254005,2001.csv,2001,0.6808033330126602,0.31919666698733984
1025,The Taking of Tiger Mountain,141654055,228984,141425071,2014.csv,2014,0.0016165015537324364,0.9983834984462676
1026,Gothika,141591324,59694580,81896744,2003.csv,2003,0.42159772444814486,0.5784022755518552
1027,Big Momma's House 2,141522961,70165972,71356989,2006.csv,2006,0.495792142166952,0.504207857833048
1028,Mona Lisa Smile,141337989,63860942,77477047,2003.csv,2003,0.4518314039405216,0.5481685960594784
1029,Scary Movie 2,141220678,71308997,69911681,2001.csv,2001,0.5049472783298774,0.49505272167012254
1030,Shallow Hal,141069860,70839203,70230657,2001.csv,2001,0.5021568958812321,0.4978431041187678
1031,Trainwreck,140795793,110212700,30583093,2015.csv,2015,0.7827840424180856,0.2172159575819144
1032,Sausage Party,140705322,97685686,43019636,2016.csv,2016,0.6942572221966131,0.3057427778033869
1033,Girls Trip,140552359,115171585,25380774,2017.csv,2017,0.8194212165446473,0.18057878345535275
1034,Step Up Revolution,140470746,35074677,105396069,2012.csv,2012,0.24969381881121355,0.7503061811887864
1035,Lion,140312928,51738905,88574023,2016.csv,2016,0.3687394008341127,0.6312605991658873
1036,The SpongeBob SquarePants Movie,140192993,85417988,54775005,2004.csv,2004,0.6092885683666087,0.3907114316333913
1037,Legend of the Guardians: The Owls of Ga'Hoole,140073390,55675313,84398077,2010.csv,2010,0.3974724464082721,0.6025275535917278
1038,Scream,140041405,81641405,58400000,2022.csv,2022,0.582980476381253,0.4170195236187469
1039,The Wolfman,139789765,61979680,77810085,2010.csv,2010,0.4433778109577622,0.5566221890422378
1040,Saw IV,139352633,63300095,76052538,2007.csv,2007,0.4542439826020367,0.5457560173979633
1041,Mr. Six,139191345,1415450,137775895,2015.csv,2015,0.010169094924688026,0.989830905075312
1042,Brüno,138805831,60054530,78751301,2009.csv,2009,0.4326513487751102,0.5673486512248899
1043,The Admiral: Roaring Currents,138342258,2589811,135752447,2014.csv,2014,0.018720317547513212,0.9812796824524868
1044,America's Sweethearts,138307673,93607673,44700000,2001.csv,2001,0.676807518842429,0.32319248115757104
1045,Let's Be Cops,138224951,82390774,55834177,2014.csv,2014,0.5960629640592168,0.40393703594078323
1046,Bridge to Terabithia,137587063,82272442,55314621,2007.csv,2007,0.5979664090947272,0.40203359090527285
1047,Stardust,137515140,38634938,98880202,2007.csv,2007,0.28095043207606085,0.7190495679239391
1048,Escape Plan,137328301,25135965,112192336,2013.csv,2013,0.18303557836923942,0.8169644216307606
1049,Death on the Nile,137307235,45630104,91677131,2022.csv,2022,0.3323211919604965,0.6676788080395035
1050,The First Purge,137056262,69488745,67567517,2018.csv,2018,0.5070089026650968,0.49299109733490326
1051,Annie,136853506,85911262,50942244,2014.csv,2014,0.6277607677804031,0.3722392322195969
1052,The Best Exotic Marigold Hotel,136836156,46412041,90424115,2012.csv,2012,0.3391796609662142,0.6608203390337858
1053,How Long Will I Love U,136796719,746933,136049786,2018.csv,2018,0.005460167505918033,0.994539832494082
1054,Remember the Titans,136706683,115654751,21051932,2000.csv,2000,0.8460065628247304,0.15399343717526962
1055,Skiptrace,136579287,0,136579287,2016.csv,2016,0.0,1.0
1056,Contagion,136515867,75658097,60857770,2011.csv,2011,0.5542073508568788,0.4457926491431212
1057,Tom & Jerry,136497537,46536687,89960850,2021.csv,2021,0.3409342616929418,0.6590657383070583
1058,The Wind Rises,136454220,5209580,131244640,2012.csv,2012,0.03817822563494189,0.9618217743650581
1059,The Bounty Hunter,136333522,67061228,69272294,2010.csv,2010,0.49189096721201114,0.5081090327879888
1060,17 Again,136316880,64167069,72149811,2009.csv,2009,0.4707199064415207,0.5292800935584794
1061,Saw: The Final Chapter,136150434,45710178,90440256,2010.csv,2010,0.3357328849939619,0.6642671150060381
1062,Unknown,135710029,63686397,72023632,2011.csv,2011,0.4692829076029451,0.5307170923970549
1063,The Jungle Book 2,135703599,47901582,87802017,2003.csv,2003,0.35298682093169836,0.6470131790683017
1064,Jack Ryan: Shadow Recruit,135503748,50577412,84926336,2014.csv,2014,0.3732547087922616,0.6267452912077384
1065,Babel,135330182,34302837,101027345,2006.csv,2006,0.2534751412659742,0.7465248587340257
1066,Perfume: The Story of a Murderer,135039924,2223293,132816631,2006.csv,2006,0.016463968092873038,0.983536031907127
1067,American Made,134866593,51342000,83524593,2017.csv,2017,0.3806873063072039,0.6193126936927961
1068,Wall Street: Money Never Sleeps,134748021,52474616,82273405,2010.csv,2010,0.38942773044510987,0.6105722695548902
1069,The Princess Diaries 2: Royal Engagement,134734481,95170481,39564000,2004.csv,2004,0.7063557917293644,0.29364420827063564
1070,Inspector Gadget,134403112,97403112,37000000,1999.csv,1999,0.7247087552556075,0.27529124474439254
1071,Last Vegas,134402450,63914167,70488283,2012.csv,2012,0.4755431690419334,0.5244568309580666
1072,The Cat in the Hat,133960541,101149285,32811256,2003.csv,2003,0.7550677553623795,0.24493224463762056
1073,Pokémon the Movie 2000,133949270,43758684,90190586,2000.csv,2000,0.32668101886632156,0.6733189811336785
1074,Point Break,133718711,28782481,104936230,2015.csv,2015,0.21524647362178057,0.7847535263782194
1075,The Big Short,133440870,70259870,63181000,2015.csv,2015,0.5265243699325401,0.47347563006745985
1076,The Artist,133432856,44671682,88761174,2011.csv,2011,0.33478772274798646,0.6652122772520136
1077,1408,132963417,71985628,60977789,2007.csv,2007,0.5413942392891422,0.4586057607108578
1078,Zero Dark Thirty,132820716,95720716,37100000,2012.csv,2012,0.7206761029657452,0.2793238970342548
1079,A Wrinkle in Time,132675864,100478608,32197256,2018.csv,2018,0.7573239394921144,0.2426760605078856
1080,Ghost Rider: Spirit of Vengeance,132563930,51774002,80789928,2012.csv,2012,0.39055874399619867,0.6094412560038014
1081,V for Vendetta,132511035,70511035,62000000,2006.csv,2006,0.5321144386201496,0.4678855613798504
1082,Be Somebody,132326332,0,132326332,2021.csv,2021,0.0,1.0
1083,The Three Musketeers,132274484,20374484,111900000,2011.csv,2011,0.1540318539439549,0.8459681460560451
1084,2 Guns,131940411,75612460,56327951,2013.csv,2013,0.5730803733815867,0.4269196266184134
1085,Blade: Trinity,131883935,52411906,79472029,2004.csv,2004,0.39740932813386254,0.6025906718661375
1086,Asterix at the Olympic Games,131856927,0,131856927,2008.csv,2008,0.0,1.0
1087,Save the Last Dance,131706809,91057006,40649803,2001.csv,2001,0.6913614162499374,0.3086385837500626
1088,Halloween Kills,131647155,92002155,39645000,2021.csv,2021,0.6988541074055113,0.30114589259448865
1089,The House with a Clock in Its Walls,131457147,68549695,62907452,2018.csv,2018,0.521460388912898,0.478539611087102
1090,Bewitched,131426169,63313159,68113010,2005.csv,2005,0.4817393634900824,0.5182606365099176
1091,School of Rock,131095614,81261177,49834437,2003.csv,2003,0.6198619047621227,0.3801380952378773
1092,Atonement,131016624,50927067,80089557,2007.csv,2007,0.3887069094376909,0.6112930905623091
1093,Munich,130982129,47403685,83578444,2005.csv,2005,0.36190956248695577,0.6380904375130443
1094,Man on Fire,130834852,77911774,52923078,2004.csv,2004,0.595497092777695,0.404502907222305
1095,"You, Me and Dupree",130628903,75628110,55000793,2006.csv,2006,0.5789538782240252,0.4210461217759748
1096,A Bad Moms Christmas,130560428,72110659,58449769,2017.csv,2017,0.5523163496369665,0.4476836503630334
1097,About a Boy,130549455,41385278,89164177,2002.csv,2002,0.317008431785487,0.682991568214513
1098,Cloud Atlas,130482868,27108272,103374596,2012.csv,2012,0.2077534960375028,0.7922465039624972
1099,Raya and the Last Dragon,130423032,54723032,75700000,2021.csv,2021,0.4195810445504748,0.5804189554495252
1100,Aliens vs. Predator: Requiem,130290885,41797066,88493819,2007.csv,2007,0.32079808192261494,0.6792019180773851
1101,Failure to Launch,130224158,88715192,41508966,2006.csv,2006,0.6812498799185939,0.3187501200814061
1102,Cheaper by the Dozen 2,130154568,82571173,47583395,2005.csv,2005,0.6344085672044949,0.3655914327955051
1103,Mean Girls,130125829,86058055,44067774,2004.csv,2004,0.6613449125461479,0.3386550874538521
1104,Red Cliff,129708433,627047,129081386,2008.csv,2008,0.004834280898297492,0.9951657191017025
1105,Julie & Julia,129540522,94125426,35415096,2009.csv,2009,0.7266099020351331,0.2733900979648669
1106,Resident Evil: Apocalypse,129342769,51201453,78141316,2004.csv,2004,0.3958586428592695,0.6041413571407305
1107,Warm Hug,129240236,0,129240236,2020.csv,2020,0.0,1.0
1108,The Fighter,129190869,93617009,35573860,2009.csv,2009,0.7246410657706777,0.27535893422932234
1109,The Woman in Black,128955898,54333290,74622608,2012.csv,2012,0.4213323379749564,0.5786676620250436
1110,Space Cowboys,128884132,90464773,38419359,2000.csv,2000,0.70190776472002,0.29809223527998
1111,The Talented Mr. Ripley,128798265,81298265,47500000,1999.csv,1999,0.6312062122886516,0.36879378771134846
1112,The Forbidden Kingdom,128779982,52075270,76704712,2008.csv,2008,0.4043739499823816,0.5956260500176184
1113,The Heartbreak Kid,128453183,36787257,91665926,2007.csv,2007,0.2863864961602392,0.7136135038397609
1114,Pan,128388320,35088320,93300000,2015.csv,2015,0.2732983810365304,0.7267016189634695
1115,Space Station 3D,128363881,93383953,34979928,2002.csv,2002,0.7274939980974866,0.2725060019025134
1116,Sister,128317206,0,128317206,2021.csv,2021,0.0,1.0
1117,Step Brothers,128107642,100468793,27638849,2008.csv,2008,0.7842529253641246,0.21574707463587536
1118,Blended,127994610,46294610,81700000,2014.csv,2014,0.36169187124364066,0.6383081287563593
1119,Law Abiding Citizen,127944208,73357727,54586481,2009.csv,2009,0.5733571542371031,0.4266428457628969
1120,The Adjustment Bureau,127869379,62495645,65373734,2010.csv,2010,0.4887459803804944,0.5112540196195057
1121,U-571,127666415,77122415,50544000,2000.csv,2000,0.6040932143351875,0.39590678566481247
1122,Ad Astra,127461872,50188370,77273502,2019.csv,2019,0.393752023350167,0.606247976649833
1123,Midway,127420861,56846802,70574059,2019.csv,2019,0.4461341852022174,0.5538658147977826
1124,March of the Penguins,127392693,77437223,49955470,2005.csv,2005,0.60786235989218,0.39213764010782
1125,Predators,127233108,52000688,75232420,2010.csv,2010,0.40870406152461514,0.5912959384753849
1126,The World Is Not Enough,126943684,126943684,0,1999.csv,1999,1.0,0.0
1127,Chronicle,126636097,64575175,62060922,2012.csv,2012,0.5099270786906833,0.49007292130931673
1128,Walking with Dinosaurs 3D,126546518,36076121,90470397,2012.csv,2012,0.2850818937586256,0.7149181062413744
1129,Sex Tape,126069509,38543473,87526036,2014.csv,2014,0.30573191968249835,0.6942680803175016
1130,This Is the End,126041322,101470202,24571120,2013.csv,2013,0.8050550437736602,0.1949449562263398
1131,The King's Man,125897478,37176373,88721105,2021.csv,2021,0.29529084768481223,0.7047091523151877
1132,The Upside,125852517,108252517,17600000,2019.csv,2019,0.860153770305603,0.13984622969439697
1133,Detective Chinatown,125842935,474252,125368683,2015.csv,2015,0.003768602504383738,0.9962313974956163
1134,Wolf Totem,125837070,210591,125626479,2015.csv,2015,0.0016735211651065938,0.9983264788348934
1135,Mechanic: Resurrection,125729635,21218403,104511232,2016.csv,2016,0.1687621458536804,0.8312378541463196
1136,Ender's Game,125544024,61737191,63806833,2013.csv,2013,0.49175730578780874,0.5082426942121913
1137,Happy Death Day,125479266,55683845,69795421,2017.csv,2017,0.44376929173302626,0.5562307082669737
1138,Captain Underpants: The First Epic Movie,125427681,73921000,51506681,2017.csv,2017,0.5893515642691345,0.4106484357308655
1139,"Legally Blonde 2: Red, White & Blonde",124914842,90186328,34728514,2003.csv,2003,0.7219824846754399,0.2780175153245601
1140,The Family Man,124745083,75793305,48951778,2000.csv,2000,0.6075855110056723,0.39241448899432774
1141,Ride Along 2,124605297,91221830,33383467,2015.csv,2015,0.7320862932496361,0.2679137067503639
1142,Coraline,124596837,75286229,49310608,2009.csv,2009,0.6042386854491338,0.39576131455086616
1143,The Thomas Crown Affair,124305181,69305181,55000000,1999.csv,1999,0.5575405662294961,0.4424594337705039
1144,Notting Hill,124182015,116089678,8092337,1999.csv,1999,0.9348348712170599,0.0651651287829401
1145,Ray,123971376,75331600,48639776,2004.csv,2004,0.6076531731002163,0.39234682689978373
1146,The Time Machine,123729176,56832494,66896682,2002.csv,2002,0.4593297703687932,0.5406702296312068
1147,The Theory of Everything,123726688,35893537,87833151,2014.csv,2014,0.2901034334645731,0.7098965665354269
1148,The Queen,123384128,56441711,66942417,2006.csv,2006,0.4574470956264326,0.5425529043735674
1149,Nanny McPhee,123276807,47144110,76132697,2005.csv,2005,0.3824248141014879,0.6175751858985121
1150,Big Fish,123218424,66809693,56408731,2003.csv,2003,0.5422053848051165,0.4577946151948835
1151,Hide and Seek,123204920,51100486,72104434,2005.csv,2005,0.41476010860605245,0.5852398913939476
1152,The Curse of La Llorona,123133739,54733739,68400000,2019.csv,2019,0.4445064321485438,0.5554935678514562
1153,The Lego Ninjago Movie,123081555,59281555,63800000,2017.csv,2017,0.4816445079849698,0.5183554920150302
1154,The Pirates! Band of Misfits,123054041,31051126,92002915,2012.csv,2012,0.25233731251458863,0.7476626874854114
1155,Looking Up,122994583,84267,122910316,2019.csv,2019,0.0006851277344466463,0.9993148722655534
1156,Zombieland: Double Tap,122810399,73123082,49687317,2019.csv,2019,0.5954144160056023,0.40458558399439776
1157,Dragon Blade,122593849,74068,122519781,2015.csv,2015,0.0006041738684621934,0.9993958261315378
1158,Spirit: Stallion of the Cimarron,122563539,73280117,49283422,2002.csv,2002,0.5978949171825073,0.40210508281749274
1159,Surrogates,122444772,38577772,83867000,2009.csv,2009,0.3150626308487879,0.6849373691512121
1160,Invictus,122233971,37491364,84742607,2009.csv,2009,0.3067180399465219,0.6932819600534781
1161,Prisoners,122126687,61002302,61124385,2013.csv,2013,0.4995001788593512,0.5004998211406488
1162,Secret Superstar,122026260,0,122026260,2017.csv,2017,0.0,1.0
1163,Peter Pan,121975011,48462608,73512403,2003.csv,2003,0.3973158731668407,0.6026841268331593
1164,Deepwater Horizon,121790373,61433527,60356846,2016.csv,2016,0.5044202221139433,0.4955797778860567
1165,Pride & Prejudice,121616555,38405088,83211467,2005.csv,2005,0.31578832339067653,0.6842116766093235
1166,Last Christmas,121550750,35150750,86400000,2019.csv,2019,0.2891857927655732,0.7108142072344268
1167,Soul,120957731,0,120957731,2020.csv,2020,0.0,1.0
1168,The Nut Job,120885527,64251541,56633986,2014.csv,2014,0.531507307735855,0.4684926922641451
1169,Intolerable Cruelty,120801243,35327628,85473615,2003.csv,2003,0.2924442424818427,0.7075557575181574
1170,Apocalypto,120673227,50866635,69806592,2006.csv,2006,0.42152378174157884,0.5784762182584211
1171,Instant Family,120556201,67363237,53192964,2018.csv,2018,0.5587704028596588,0.4412295971403412
1172,Eight Below,120455994,81612565,38843429,2006.csv,2006,0.6775301277244866,0.3224698722755133
1173,Red Cliff II,120432178,0,120432178,2009.csv,2009,0.0,1.0
1174,We Bought a Zoo,120081841,75624550,44457291,2011.csv,2011,0.629775071486454,0.37022492851354605
1175,The Pianist,120072577,32572577,87500000,2002.csv,2002,0.27127407284679167,0.7287259271532084
1176,The Omen,119974972,54607383,65367589,2006.csv,2006,0.4551564554647281,0.544843544535272
1177,The Commuter,119942387,36343858,83598529,2017.csv,2017,0.3030109614210029,0.6969890385789971
1178,Extreme Job,119932733,1565885,118366848,2019.csv,2019,0.013056360518358236,0.9869436394816418
1179,The Addams Family 2,119815153,56489153,63326000,2021.csv,2021,0.4714691888763018,0.5285308111236982
1180,Parental Guidance,119772232,77267296,42504936,2012.csv,2012,0.6451186114658028,0.35488138853419715
1181,Road Trip,119754278,68540777,51213501,2000.csv,2000,0.5723451232364325,0.4276548767635675
1182,Spy Kids 2: Island of Lost Dreams,119723358,85846429,33876929,2002.csv,2002,0.7170399363505991,0.2829600636494008
1183,Dora and the Lost City of Gold,119682635,60477943,59204692,2019.csv,2019,0.505319280445321,0.4946807195546789
1184,Wonder Park,119559110,45216793,74342317,2019.csv,2019,0.37819613244026323,0.6218038675597368
1185,Allied,119520023,40098064,79421959,2016.csv,2016,0.33549243878575896,0.664507561214241
1186,Charlie Wilson's War,119483446,66661095,52822351,2007.csv,2007,0.5579107167699198,0.44208928323008023
1187,Sahara,119240351,68671925,50568426,2005.csv,2005,0.5759117985152526,0.4240882014847474
1188,Unfaithful,119137784,52775765,66362019,2002.csv,2002,0.442980918631154,0.557019081368846
1189,I Belonged to You,119107580,744541,118363039,2016.csv,2016,0.006250995948368693,0.9937490040516314
1190,The Shallows,119100758,55124043,63976715,2016.csv,2016,0.46283536667331704,0.537164633326683
1191,Forever Young,119055731,0,119055731,2017.csv,2017,0.0,1.0
1192,Final Destination 3,118890272,54098051,64792221,2006.csv,2006,0.4550250419142787,0.5449749580857213
1193,Message in a Bottle,118880016,52880016,66000000,1999.csv,1999,0.4448183788938925,0.5551816211061075
1194,Hankyu Railways - A 15-minute Miracle,118799256,0,118799256,2011.csv,2011,0.0,1.0
1195,Lost in Translation,118685453,44585453,74100000,2003.csv,2003,0.3756606380396088,0.6243393619603912
1196,The Purge: Election Year,118587880,79213375,39374505,2016.csv,2016,0.6679719293405025,0.3320280706594974
1197,Jurassic Park 2013 Re-release,118192315,45385935,72806380,2013.csv,2013,0.38400072796611184,0.6159992720338882
1198,A Cool Fish,118153135,551876,117601259,2018.csv,2018,0.004670853634141828,0.9953291463658581
1199,Disturbia,118114220,80209692,37904528,2007.csv,2007,0.6790858204879988,0.3209141795120012
1200,Why Him?,118102725,60323786,57778939,2016.csv,2016,0.5107738707976467,0.4892261292023533
1201,Corpse Bride,118090836,53359111,64731725,2005.csv,2005,0.4518480248543587,0.5481519751456413
1202,P Storm,117991727,326711,117665016,2019.csv,2019,0.0027689314183866466,0.9972310685816134
1203,Saving Mr. Banks,117867984,83301580,34566404,2013.csv,2013,0.7067362753909493,0.29326372460905076
1204,Pompeii,117831631,23219748,94611883,2014.csv,2014,0.19705869979852864,0.8029413002014714
1205,Magic Mike XXL,117813057,66013057,51800000,2015.csv,2015,0.5603203811271954,0.43967961887280455
1206,The Notebook,117812623,81001787,36810836,2004.csv,2004,0.6875476068468487,0.3124523931531513
1207,Blue Streak,117758500,68518533,49239967,1999.csv,1999,0.581856367056306,0.4181436329436941
1208,Game Night,117679066,69179066,48500000,2018.csv,2018,0.5878621266419637,0.41213787335803637
1209,The Forgotten,117592831,67133509,50459322,2004.csv,2004,0.5708979742140914,0.42910202578590867
1210,A Knight's Tale,117487473,56569702,60917771,2001.csv,2001,0.4814956059187689,0.5185043940812311
1211,Hotel for Dogs,117252578,73034460,44218118,2009.csv,2009,0.6228814858126189,0.377118514187381
1212,Paycheck,117248958,53790451,63458507,2003.csv,2003,0.4587712498050516,0.5412287501949484
1213,Water for Elephants,117094902,58709717,58385185,2011.csv,2011,0.5013857648559286,0.49861423514407144
1214,Warm Bodies,116980662,66380662,50600000,2013.csv,2013,0.5674498747493838,0.4325501252506162
1215,Barnyard,116755080,72637803,44117277,2006.csv,2006,0.6221382658467624,0.3778617341532377
1216,Finding Neverland,116650613,51680613,64970000,2004.csv,2004,0.4430376461030685,0.5569623538969315
1217,Freddy vs. Jason,116632628,82622655,34009973,2003.csv,2003,0.7084008687517527,0.29159913124824727
1218,Abraham Lincoln: Vampire Hunter,116471580,37519139,78952441,2012.csv,2012,0.32213127872052566,0.6778687212794744
1219,Personal Tailor,116126458,375892,115750566,2013.csv,2013,0.0032369195312923434,0.9967630804687077
1220,Body of Lies,115900897,39394666,76506231,2008.csv,2008,0.33989957817151323,0.6601004218284868
1221,The Chronicles of Riddick,115900534,57761012,58139522,2004.csv,2004,0.49836709121633554,0.5016329087836644
1222,The Iron Lady,115890699,30017992,85872707,2011.csv,2011,0.25901985456140875,0.7409801454385913
1223,Dragon Ball Super: Broly,115757940,30712119,85045821,2018.csv,2018,0.26531328218176653,0.7346867178182335
1224,A Nightmare on Elm Street,115694863,63075011,52619852,2010.csv,2010,0.5451841971583474,0.4548158028416525
1225,Detective Conan: The Fist of Blue Sapphire,115570314,0,115570314,2019.csv,2019,0.0,1.0
1226,Closer,115505027,33987757,81517270,2004.csv,2004,0.2942534873395597,0.7057465126604403
1227,Bride Wars,115375850,58715510,56660340,2009.csv,2009,0.5089064132571938,0.49109358674280623
1228,Pitch Perfect,115350426,65001093,50349333,2012.csv,2012,0.5635097784554346,0.4364902215445654
1229,The Gentlemen,115171795,36471795,78700000,2019.csv,2019,0.31667297535824634,0.6833270246417537
1230,The Monkey King 3,115084576,187074,114897502,2018.csv,2018,0.0016255349457081026,0.998374465054292
1231,Snow Dogs,115035090,81172560,33862530,2002.csv,2002,0.7056330377104933,0.2943669622895066
1232,Dear John,114984666,80014842,34969824,2010.csv,2010,0.6958740220195969,0.3041259779804031
1233,So Young,114926694,11186,114915508,2013.csv,2013,9.733160861653256e-05,0.9999026683913834
1234,The Lake House,114830111,52330111,62500000,2006.csv,2006,0.455717673215521,0.5442823267844791
1235,Book of Love,114679097,0,114679097,2016.csv,2016,0.0,1.0
1236,We Were Soldiers,114660784,78122718,36538066,2002.csv,2002,0.6813377274657393,0.3186622725342607
1237,Office Christmas Party,114501299,54767494,59733805,2016.csv,2016,0.47831329843690246,0.5216867015630976
1238,Hope Springs,114281051,63536011,50745040,2012.csv,2012,0.5559627816163504,0.4440372183836496
1239,The Score,114252154,71107711,43144443,2001.csv,2001,0.6223752332931947,0.3776247667068054
1240,Step Up,114194847,65328121,48866726,2006.csv,2006,0.5720759098700837,0.4279240901299163
1241,Seventh Son,114178613,17223265,96955348,2014.csv,2014,0.15084493100297164,0.8491550689970284
1242,My Love,114016434,86252,113930182,2021.csv,2021,0.0007564874375916721,0.9992435125624083
1243,Anna and the King,113996937,39263420,74733517,1999.csv,1999,0.3444252190740879,0.655574780925912
1244,Coyote Ugly,113916474,60786269,53130205,2000.csv,2000,0.5336038490798092,0.4663961509201909
1245,Saw V,113864059,56746769,57117290,2008.csv,2008,0.49837296771582684,0.5016270322841732
1246,Insomnia,113714830,67355513,46359317,2002.csv,2002,0.5923195154053346,0.40768048459466544
1247,Changeling,113398237,35739802,77658435,2008.csv,2008,0.31517070234522254,0.6848292976547775
1248,Rambo,113244290,42754105,70490185,2008.csv,2008,0.37753872623511525,0.6224612737648847
1249,The Dark Tower,113231078,50701325,62529753,2017.csv,2017,0.44776863291895885,0.5522313670810411
1250,Pet Sematary,113118226,54724696,58393530,2019.csv,2019,0.4837831880425706,0.5162168119574294
1251,White Chicks,113086475,70831760,42254715,2004.csv,2004,0.6263504101617811,0.37364958983821894
1252,Insidious: Chapter 3,112983889,52218558,60765331,2015.csv,2015,0.46217702773534375,0.5378229722646563
1253,Final Destination,112880294,53331147,59549147,2000.csv,2000,0.47245754870199047,0.5275424512980096
1254,Cats & Dogs: The Revenge of Kitty Galore,112483764,43585753,68898011,2010.csv,2010,0.3874848373672844,0.6125151626327155
1255,Tooth Fairy,112462508,60022256,52440252,2010.csv,2010,0.5337090295016362,0.46629097049836377
1256,Boonie Bears: Blast Into the Past,112367881,0,112367881,2019.csv,2019,0.0,1.0
1257,How to Be Single,112343513,46843513,65500000,2016.csv,2016,0.4169667811616324,0.5830332188383677
1258,The Exorcist 2000 Director's Cut,112053066,39671011,72382055,2000.csv,2000,0.3540377110252387,0.6459622889747613
1259,The Purge: Anarchy,111928365,71962800,39965565,2014.csv,2014,0.6429362208587609,0.35706377914123916
1260,"Dad, Where Are We Going?",111870000,0,111870000,2014.csv,2014,0.0,1.0
1261,Get Hard,111711453,90411453,21300000,2015.csv,2015,0.809330203591569,0.19066979640843093
1262,Underworld: Evolution,111476513,62318875,49157638,2006.csv,2006,0.5590314347202446,0.44096856527975536
1263,Fool's Gold,111231041,70231041,41000000,2008.csv,2008,0.6313978577257044,0.36860214227429555
1264,The Call of the Wild,111105497,62342368,48763129,2020.csv,2020,0.5611096631879519,0.4388903368120481
1265,The Dukes of Hazzard,111069515,80270227,30799288,2005.csv,2005,0.7227025975579348,0.27729740244206524
1266,Good Boys,111037232,83140306,27896926,2019.csv,2019,0.748760613917321,0.251239386082679
1267,Mission to Mars,110983407,60883407,50100000,2000.csv,2000,0.5485811676334643,0.4514188323665357
1268,The Santa Clause 3: The Escape Clause,110768122,84500122,26268000,2006.csv,2006,0.7628559595873622,0.23714404041263784
1269,Free Birds,110387072,55750480,54636592,2013.csv,2013,0.5050453734292364,0.49495462657076367
1270,The Kid,110317580,69691949,40625631,2000.csv,2000,0.6317392839835682,0.36826071601643184
1271,10 Cloverfield Lane,110216998,72082998,38134000,2016.csv,2016,0.6540098107190326,0.34599018928096736
1272,Moneyball,110206216,75605492,34600724,2011.csv,2011,0.6860365480654921,0.3139634519345079
1273,Buddies in India,110155128,293194,109861934,2017.csv,2017,0.002661646401064506,0.9973383535989355
1274,Hoodwinked,110013167,51386611,58626556,2005.csv,2005,0.46709509780770153,0.5329049021922985
1275,The 5th Wave,109906372,34916787,74989585,2015.csv,2015,0.3176957474312772,0.6823042525687227
1276,Peter Pan 2: Return to Never Land,109862682,48430258,61432424,2002.csv,2002,0.4408253750805028,0.5591746249194972
1277,Sideways,109706931,71503593,38203338,2004.csv,2004,0.6517691484779572,0.34823085152204286
1278,The Prestige,109676311,53089891,56586420,2006.csv,2006,0.4840597802382321,0.5159402197617678
1279,Treasure Planet,109578115,38176783,71401332,2002.csv,2002,0.3483978803614207,0.6516021196385793
1280,Along With the Gods: The Two Worlds,109383972,1908823,107475149,2017.csv,2017,0.017450664526974757,0.9825493354730253
1281,Billy Elliot,109280263,21995263,87285000,2000.csv,2000,0.20127388419627065,0.7987261158037293
1282,Transporter 3,108979549,31715062,77264487,2008.csv,2008,0.2910184735669993,0.7089815264330007
1283,Earth,108975160,32011576,76963584,2007.csv,2007,0.293751126403485,0.706248873596515
1284,The Reader,108902486,34194407,74708079,2008.csv,2008,0.3139910598551442,0.6860089401448558
1285,The Hours,108846072,41675994,67170078,2002.csv,2002,0.382889278723811,0.617110721276189
1286,Sanctum,108609310,23209310,85400000,2010.csv,2010,0.2136954005140075,0.7863045994859925
1287,Cinderella Man,108539911,61649911,46890000,2005.csv,2005,0.5679930122662437,0.4320069877337563
1288,Confessions of a Shopaholic,108394089,44277350,64116739,2009.csv,2009,0.40848491286273,0.59151508713727
1289,The Boxtrolls,108255770,50837305,57418465,2014.csv,2014,0.4696036525351027,0.5303963474648973
1290,Hidalgo,108040622,67303450,40737172,2004.csv,2004,0.6229457842254925,0.3770542157745075
1291,Asterix & Obelix: Mission Cleopatra,108012365,0,108012365,2002.csv,2002,0.0,1.0
1292,Neighbors 2: Sorority Rising,108007109,55455765,52551344,2016.csv,2016,0.5134455084803723,0.48655449151962765
1293,Arthur and the Invisibles,107944236,15132763,92811473,2006.csv,2006,0.14019056098558147,0.8598094390144185
1294,Three Kings,107752036,60652036,47100000,1999.csv,1999,0.5628852897034818,0.4371147102965182
1295,Horrible Bosses 2,107645357,54445357,53200000,2014.csv,2014,0.5057845365313806,0.49421546346861944
1296,Paul Blart: Mall Cop 2,107588225,71038190,36550035,2015.csv,2015,0.6602784830774929,0.33972151692250707
1297,The Amityville Horror,107516369,65233369,42283000,2005.csv,2005,0.6067296506265013,0.39327034937349864
1298,Clifford the Big Red Dog,107347356,48947356,58400000,2021.csv,2021,0.4559716962195138,0.5440283037804862
1299,Vacation,107228221,58884188,48344033,2015.csv,2015,0.5491482321617552,0.45085176783824477
1300,Shaft,107196498,70334258,36862240,2000.csv,2000,0.656124587204332,0.343875412795668
1301,ParaNorman,107139399,56003051,51136348,2012.csv,2012,0.5227120137196215,0.4772879862803785
1302,The Texas Chainsaw Massacre,107071655,80571655,26500000,2003.csv,2003,0.7525021911728179,0.24749780882718214
1303,Harmony,107056263,0,107056263,2010.csv,2010,0.0,1.0
1304,The Man from U.N.C.L.E.,107045109,45445109,61600000,2015.csv,2015,0.42454166682197503,0.575458333178025
1305,The Breakup Guru,106980263,208959,106771304,2014.csv,2014,0.00195324814260365,0.9980467518573963
1306,Hereafter,106956330,32746941,74209389,2010.csv,2010,0.30617113545313307,0.693828864546867
1307,Made of Honor,106407672,46012734,60394938,2008.csv,2008,0.43241932780937076,0.5675806721906292
1308,Race to Witch Mountain,106387141,67172594,39214547,2009.csv,2009,0.6313976799132143,0.3686023200867857
1309,Chronicles of the Ghostly Tribe,106380000,0,106380000,2015.csv,2015,0.0,1.0
1310,The Whole Nine Yards,106371651,57262492,49109159,2000.csv,2000,0.5383247459419428,0.46167525405805726
1311,Shaun the Sheep Movie,106209378,19375982,86833396,2015.csv,2015,0.18243193176406702,0.817568068235933
1312,About Schmidt,105834556,65016287,40818269,2002.csv,2002,0.6143200241705554,0.3856799758294446
1313,Forgetting Sarah Marshall,105833257,63172463,42660794,2008.csv,2008,0.5969055927287582,0.4030944072712418
1314,Life as We Know It,105734416,53374681,52359735,2010.csv,2010,0.50479950634049,0.4952004936595101
1315,First Man,105697415,44936545,60760870,2018.csv,2018,0.4251432733714443,0.5748567266285557
1316,Planet 51,105647102,42194060,63453042,2009.csv,2009,0.39938681895883904,0.600613181041161
1317,The Brothers Grimm,105316267,37916267,67400000,2005.csv,2005,0.36002289181024616,0.6399771081897538
1318,Gangster Squad,105200903,46000903,59200000,2013.csv,2013,0.4372671877160598,0.5627328122839402
1319,Along Came a Spider,105178561,74078174,31100387,2001.csv,2001,0.7043086851131192,0.2956913148868808
1320,Sisters,105011053,87044645,17966408,2015.csv,2015,0.8289093625220576,0.17109063747794245
1321,The Campaign,104907746,86907746,18000000,2012.csv,2012,0.8284206773444546,0.17157932265554537
1322,Training Day,104876233,76631907,28244326,2001.csv,2001,0.7306889731632523,0.2693110268367477
1323,Let the Bullets Fly,104723314,63012,104660302,2010.csv,2010,0.0006016998277957476,0.9993983001722042
1324,Scary Stories to Tell in the Dark,104545505,68947075,35598430,2019.csv,2019,0.6594934425922951,0.3405065574077049
1325,The Hitchhiker's Guide to the Galaxy,104478416,51085416,53393000,2005.csv,2005,0.48895664727535687,0.5110433527246432
1326,Book Club,104438188,68566296,35871892,2018.csv,2018,0.6565251400187065,0.34347485998129346
1327,The Girl with the Dragon Tattoo,104414200,10095170,94319030,2009.csv,2009,0.09668388016189369,0.9033161198381063
1328,The Tuxedo,104391623,50547998,53843625,2002.csv,2002,0.4842150792118636,0.5157849207881364
1329,The Cell,104155843,61334059,42821784,2000.csv,2000,0.5888681540410555,0.4111318459589444
1330,Little Man,104003322,58645052,45358270,2006.csv,2006,0.5638767192455642,0.4361232807544359
1331,The Water Horse,103967384,40946255,63021129,2007.csv,2007,0.3938375038848722,0.6061624961151278
1332,Wrath of Man,103966489,27466489,76500000,2021.csv,2021,0.26418598208120697,0.7358140179187931
1333,Immortal Demon Slayer,103818506,0,103818506,2017.csv,2017,0.0,1.0
1334,Ouija,103590271,50856010,52734261,2014.csv,2014,0.49093423068658637,0.5090657693134136
1335,The Stepford Wives,103370127,59484742,43885385,2004.csv,2004,0.5754538929801257,0.42454610701987433
1336,Rugrats in Paris,103291131,76507756,26783375,2000.csv,2000,0.7407001478181123,0.2592998521818877
1337,Birdman or (The Unexpected Virtue of Ignorance),103215094,42340598,60874496,2014.csv,2014,0.41021711417518064,0.5897828858248194
1338,Cold War 2,103197501,560824,102636677,2016.csv,2016,0.00543447268165922,0.9945655273183408
1339,She's All That,103166989,63366989,39800000,1999.csv,1999,0.614217683526656,0.385782316473344
1340,Guess Who,103121466,68915888,34205578,2005.csv,2005,0.6682981795468268,0.33170182045317315
1341,Night School,103105878,77339130,25766748,2018.csv,2018,0.75009428657404,0.24990571342596005
1342,Saw,103096345,55185045,47911300,2004.csv,2004,0.5352764445723076,0.4647235554276924
1343,Transcendence,103039258,23022309,80016949,2014.csv,2014,0.22343240282262125,0.7765675971773788
1344,Jimmy Neutron: Boy Genius,102992536,80936232,22056304,2001.csv,2001,0.7858456072972123,0.21415439270278772
1345,Resident Evil,102984862,40119709,62865153,2002.csv,2002,0.3895689931594024,0.6104310068405976
1346,Jigsaw,102952888,38052832,64900056,2017.csv,2017,0.3696140316141496,0.6303859683858505
1347,Just Like Heaven,102854431,48318130,54536301,2005.csv,2005,0.4697719828910434,0.5302280171089566
1348,Love & Other Drugs,102820008,32367005,70453003,2010.csv,2010,0.31479286599549766,0.6852071340045023
1349,Chappie,102811889,31569268,71242621,2015.csv,2015,0.3070585348354022,0.6929414651645979
1350,Star Wars: Episode I - The Phantom Menace 2012 3D Release,102739593,43456382,59283211,2012.csv,2012,0.4229759991359903,0.5770240008640096
1351,Project X,102731865,54731865,48000000,2012.csv,2012,0.5327642499238187,0.46723575007618134
1352,Zombieland,102392080,75590286,26801794,2009.csv,2009,0.7382434852383114,0.2617565147616886
1353,Ghosts of Girlfriends Past,102366815,55250026,47116789,2009.csv,2009,0.5397259453661815,0.4602740546338186
1354,The Wild,102338515,37384046,64954469,2006.csv,2006,0.36529791349815854,0.6347020865018415
1355,Dawn of the Dead,102278712,59020957,43257755,2004.csv,2004,0.5770600337634287,0.4229399662365713
1356,John Q,102244770,71756802,30487968,2002.csv,2002,0.7018139118509436,0.29818608814905645
1357,Railroad Tigers,102205175,218044,101987131,2016.csv,2016,0.002133394908819441,0.9978666050911805
1358,Heaven Is for Real,101888019,91443253,10444766,2014.csv,2014,0.8974877900020806,0.10251220999791938
1359,Detective Conan: Zero the Enforcer,101860359,0,101860359,2018.csv,2018,0.0,1.0
1360,The Devil Inside,101758490,53261944,48496546,2012.csv,2012,0.5234152354265477,0.4765847645734523
1361,Pineapple Express,101624843,87341380,14283463,2008.csv,2008,0.8594491014367422,0.1405508985632578
1362,Just Married,101564935,56127162,45437773,2003.csv,2003,0.5526234226408947,0.4473765773591053
1363,Miss Congeniality 2: Armed & Fabulous,101393569,48478006,52915563,2005.csv,2005,0.4781171673718281,0.5218828326281719
1364,The Black Phone,101370065,64773065,36597000,2022.csv,2022,0.6389762599047362,0.36102374009526383
1365,The Time Traveler's Wife,101344412,63414846,37929566,2009.csv,2009,0.625735990258644,0.37426400974135604
1366,Hitman,101276318,39687694,61588624,2007.csv,2007,0.3918753641892866,0.6081246358107134
1367,The Recruit,101191884,52802140,48389744,2003.csv,2003,0.5218021239727091,0.47819787602729086
1368,Joy,101134059,56451232,44682827,2015.csv,2015,0.5581822044737669,0.4418177955262332
1369,Little Miss Sunshine,101058954,59891098,41167856,2006.csv,2006,0.5926352453638101,0.4073647546361899
1370,Kung Fu Hustle,100912445,17108591,83803854,2004.csv,2004,0.16953896023429024,0.8304610397657097
1371,Fight Club,100853753,37030102,63823651,1999.csv,1999,0.3671663264727491,0.6328336735272508
1372,My Bloody Valentine,100734718,51545952,49188766,2009.csv,2009,0.5116999682274387,0.48830003177256126
1373,"Alexander and the Terrible, Horrible, No Good, Very Bad Day",100654149,66954149,33700000,2014.csv,2014,0.665190155251325,0.334809844748675
1374,Silent Hill,100605135,46982632,53622503,2006.csv,2006,0.46700033750762326,0.5329996624923767
1375,Ladder 49,100572044,74541707,26030337,2004.csv,2004,0.7411772102394578,0.2588227897605422
1376,Life,100541806,30234022,70307784,2017.csv,2017,0.30071095003008,0.69928904996992
1377,Instructions Not Included,100486616,44467206,56019410,2013.csv,2013,0.44251869323572407,0.557481306764276
1378,Tammy,100375432,84525432,15850000,2014.csv,2014,0.8420928340313395,0.15790716596866053
1379,PK,100370104,10616104,89754000,2014.csv,2014,0.10576958254422054,0.8942304174557795
1380,Aftershock,100293273,62962,100230311,2010.csv,2010,0.0006277788940041871,0.9993722211059958
1381,The Good Shepherd,100266865,59952835,40314030,2006.csv,2006,0.5979326769616263,0.40206732303837367
1382,Any Given Sunday,100230832,75530832,24700000,1999.csv,1999,0.7535688419707022,0.2464311580292978
1383,Where the Wild Things Are,100140096,77233467,22906629,2009.csv,2009,0.7712541737527394,0.22874582624726064
1384,Philomena,100129872,37709979,62419893,2013.csv,2013,0.376610678180034,0.623389321819966
1385,The Continent,100125957,0,100125957,2014.csv,2014,0.0,1.0
1386,Nim's Island,100104565,48006762,52097803,2008.csv,2008,0.4795661616430779,0.520433838356922
1387,Don't Say a Word,100020092,55001642,45018450,2001.csv,2001,0.5499059328999617,0.45009406710003824
1388,Atomic Blonde,100014025,51687870,48326155,2017.csv,2017,0.5168062179279356,0.48319378207206437
1389,The Book of Life,99783556,50151543,49632013,2014.csv,2014,0.5026032846534353,0.4973967153465647
1390,Black Mass,99775678,62575678,37200000,2015.csv,2015,0.6271636460340565,0.3728363539659435
1391,RRR,99746831,11113000,88633831,2022.csv,2022,0.11141206080020728,0.8885879391997927
1392,The Roundup,99574606,812859,98761747,2022.csv,2022,0.008163316257560688,0.9918366837424393
1393,Insidious,99557032,54009150,45547882,2011.csv,2011,0.5424945773795266,0.45750542262047345
1394,Line Walker 2: Invisible Spy,99482027,296751,99185276,2019.csv,2019,0.002982960932229497,0.9970170390677705
1395,The Lucky One,99357138,60457138,38900000,2012.csv,2012,0.6084830865397914,0.39151691346020856
1396,Hellboy,99318987,59623958,39695029,2004.csv,2004,0.600327890980201,0.399672109019799
1397,Shanghai Noon,99274467,56937502,42336965,2000.csv,2000,0.5735362145031713,0.42646378549682873
1398,Nacho Libre,99255460,80197993,19057467,2006.csv,2006,0.8079957817937673,0.19200421820623267
1399,Blue Jasmine,99104804,33405481,65699323,2013.csv,2013,0.3370722674553698,0.6629277325446302
1400,Ode to My Father,99085291,2300121,96785170,2014.csv,2014,0.023213546398122804,0.9767864536018772
1401,Justin Bieber: Never Say Never,99036827,73013910,26022917,2011.csv,2011,0.7372399965923787,0.2627600034076213
1402,Young Detective Dee: Rise of the Sea Dragon,98774891,87783,98687108,2013.csv,2013,0.0008887177612780155,0.999111282238722
1403,Spotlight,98690254,45055776,53634478,2015.csv,2015,0.45653723821604514,0.5434627617839549
1404,Umizaru 3: The Last Message,98663381,0,98663381,2010.csv,2010,0.0,1.0
1405,Bowfinger,98625775,66384775,32241000,1999.csv,1999,0.6730976258488209,0.32690237415117906
1406,Devil and Angel,98599942,131058,98468884,2015.csv,2015,0.0013291894228497619,0.9986708105771502
1407,The Visit,98450062,65206105,33243957,2015.csv,2015,0.6623267032579421,0.3376732967420579
1408,Crash,98410061,54580300,43829761,2005.csv,2005,0.5546211377716757,0.4453788622283244
1409,Evolution,98376292,38345494,60030798,2001.csv,2001,0.38978389224102894,0.6102161077589711
1410,Riddick,98337295,42025135,56312160,2013.csv,2013,0.4273570368190421,0.572642963180958
1411,Deep Sea,98230905,46412757,51818148,2006.csv,2006,0.47248630153616117,0.5275136984638389
1412,Alpha,98203196,35857181,62346015,2018.csv,2018,0.36513252582940375,0.6348674741705962
1413,Killers,98159963,47059963,51100000,2010.csv,2010,0.4794211566685289,0.5205788433314711
1414,Once Upon a Time in Mexico,98096026,56359780,41736246,2003.csv,2003,0.5745368318997958,0.4254631681002042
1415,Paul,97984015,37412945,60571070,2011.csv,2011,0.3818270255612612,0.6181729744387388
1416,Along With the Gods: The Last 49 Days,97962238,1200246,96761992,2018.csv,2018,0.012252129233715547,0.9877478707662845
1417,Are We There Yet?,97918663,82674398,15244265,2005.csv,2005,0.8443170634386623,0.15568293656133764
1418,Fred Claus,97838349,72006777,25831572,2007.csv,2007,0.7359770247145114,0.2640229752854885
1419,Phone Booth,97837138,46566212,51270926,2003.csv,2003,0.4759564001146477,0.5240435998853523
1420,I Am Sam,97818139,40311852,57506287,2001.csv,2001,0.4121101915463757,0.5878898084536244
1421,A Simple Favor,97644617,53548586,44096031,2018.csv,2018,0.5484028474401206,0.4515971525598795
1422,Safe Haven,97594140,71349120,26245020,2013.csv,2013,0.7310799603336839,0.26892003966631606
1423,The Little Prince,97571250,1339152,96232098,2015.csv,2015,0.013724862600407395,0.9862751373995926
1424,Evil Dead,97542952,54239856,43303096,2013.csv,2013,0.5560612518677925,0.44393874813220746
1425,42,97470701,95020213,2450488,2013.csv,2013,0.9748592348792074,0.025140765120792555
1426,Scream 4,97138686,38180928,58957758,2011.csv,2011,0.39305584183010256,0.6069441581698974
1427,Jarhead,97076152,62658220,34417932,2005.csv,2005,0.6454543027210226,0.35454569727897745
1428,Legend of the Demon Cat,97051623,0,97051623,2017.csv,2017,0.0,1.0
1429,Enemy at the Gates,96976270,51401758,45574512,2001.csv,2001,0.530044700626246,0.469955299373754
1430,The Shack,96942115,57386418,39555697,2017.csv,2017,0.5919658138261168,0.40803418617388326
1431,Boonie Bears: The Big Shrink,96845907,0,96845907,2018.csv,2018,0.0,1.0
1432,Old Dogs,96753696,49492060,47261636,2009.csv,2009,0.5115262986956075,0.48847370130439255
1433,The Butterfly Effect,96693417,57938693,38754724,2004.csv,2004,0.5991999744925759,0.40080002550742416
1434,8MM,96618699,36663315,59955384,1999.csv,1999,0.37946396897768203,0.6205360310223179
1435,Christmas with the Kranks,96572480,73780539,22791941,2004.csv,2004,0.7639913461888935,0.23600865381110644
1436,The Rite,96560591,33047633,63512958,2011.csv,2011,0.34224762563849676,0.6577523743615032
1437,13 Going on 30,96455697,57231747,39223950,2004.csv,2004,0.5933475033620875,0.4066524966379124
1438,Vicky Cristina Barcelona,96409300,23216709,73192591,2008.csv,2008,0.24081399823461014,0.7591860017653899
1439,Contraband,96262212,66528000,29734212,2012.csv,2012,0.6911123131057907,0.3088876868942093
1440,Red Eye,96258201,57891803,38366398,2005.csv,2005,0.6014220336405415,0.3985779663594586
1441,Kick-Ass,96188903,48071303,48117600,2010.csv,2010,0.4997593433413,0.5002406566587
1442,The Tigger Movie,96159800,45554533,50605267,2000.csv,2000,0.4737378093548448,0.5262621906451552
1443,Assassination,96119773,1904682,94215091,2015.csv,2015,0.019815714712518098,0.9801842852874819
1444,The Manchurian Candidate,96105910,65955630,30150280,2004.csv,2004,0.6862806876288877,0.3137193123711122
1445,The 6th Day,96085477,34604280,61481197,2000.csv,2000,0.36014058607420973,0.6398594139257903
1446,Think Like a Man,96070507,91547205,4523302,2012.csv,2012,0.9529168509540602,0.04708314904593977
1447,Dolphin Tale,95932565,72286779,23645786,2011.csv,2011,0.7535165874069978,0.2464834125930022
1448,The Favourite,95918706,34366783,61551923,2018.csv,2018,0.35829072798375744,0.6417092720162426
1449,TMNT,95797812,54149098,41648714,2007.csv,2007,0.5652435777969542,0.4347564222030457
1450,Be Cool,95763716,56046979,39716737,2005.csv,2005,0.5852632013569733,0.41473679864302676
1451,Qing sheng,95721752,100026,95621726,2016.csv,2016,0.0010449662475881135,0.9989550337524119
1452,My Sister's Keeper,95714875,49200230,46514645,2009.csv,2009,0.5140290890000118,0.48597091099998824
1453,Underworld,95708457,51970690,43737767,2003.csv,2003,0.5430104259229673,0.4569895740770327
1454,Shooter,95696996,47003582,48693414,2007.csv,2007,0.49117092452933425,0.5088290754706658
1455,The New King of Comedy,95618308,0,95618308,2019.csv,2019,0.0,1.0
1456,Detective Conan: The Scarlet Bullet,95580715,0,95580715,2021.csv,2021,0.0,1.0
1457,Poltergeist,95437994,47425125,48012869,2015.csv,2015,0.49692080703205055,0.5030791929679495
1458,The Mortal Instruments: City of Bones,95396573,31165421,64231152,2013.csv,2013,0.32669329746258285,0.6733067025374172
1459,Truth or Dare,95330493,41411015,53919478,2018.csv,2018,0.43439421843753606,0.565605781562464
1460,Rush,95224595,26947624,68276971,2013.csv,2013,0.28299016656358583,0.7170098334364142
1461,40 Days and 40 Nights,95146283,37950822,57195461,2002.csv,2002,0.3988681512655623,0.6011318487344377
1462,The Hustle,95017038,35417038,59600000,2019.csv,2019,0.3727440756467277,0.6272559243532723
1463,Adoring,94975692,0,94975692,2019.csv,2019,0.0,1.0
1464,The Guardian,94973540,55011732,39961808,2006.csv,2006,0.5792321945670341,0.4207678054329659
1465,Changing Lanes,94935764,66818548,28117216,2002.csv,2002,0.7038290438153528,0.2961709561846471
1466,Green Zone,94882549,35053660,59828889,2009.csv,2009,0.36944264640276475,0.6305573535972353
1467,Kill Mobile,94870905,0,94870905,2018.csv,2018,0.0,1.0
1468,The Wedding Planner,94728529,60400856,34327673,2001.csv,2001,0.6376205419594344,0.3623794580405656
1469,I Feel Pretty,94539426,48795601,45743825,2018.csv,2018,0.5161402291568811,0.48385977084311893
1470,Veteran,94393020,1200627,93192393,2015.csv,2015,0.01271944684045494,0.9872805531595451
1471,Masquerade,94268432,922921,93345511,2012.csv,2012,0.009790350602203715,0.9902096493977963
1472,Police Story: Lockdown,94249025,0,94249025,2013.csv,2013,0.0,1.0
1473,Fleet of Time,94244191,569280,93674911,2014.csv,2014,0.006040478399353017,0.9939595216006469
1474,Dirty Grandpa,94073028,35593113,58479915,2016.csv,2016,0.378356195784407,0.6216438042155931
1475,Ben-Hur,94061311,26410477,67650834,2016.csv,2016,0.2807793844166174,0.7192206155833827
1476,Blockers,94017294,60311495,33705799,2018.csv,2018,0.6414936277574634,0.35850637224253656
1477,The Skeleton Key,93983911,47907715,46076196,2005.csv,2005,0.5097437900833899,0.49025620991661006
1478,Syriana,93974620,50824620,43150000,2005.csv,2005,0.540833471845909,0.459166528154091
1479,Speed Racer,93945766,43945766,50000000,2008.csv,2008,0.46777803695804665,0.5322219630419533
1480,In the Heart of the Sea,93920758,25020758,68900000,2015.csv,2015,0.26640285420183685,0.7335971457981632
1481,Forces of Nature,93900680,52900680,41000000,1999.csv,1999,0.5633684441901805,0.4366315558098195
1482,The Man from Macau,93864936,0,93864936,2014.csv,2014,0.0,1.0
1483,Rien à déclarer,93811164,0,93811164,2011.csv,2011,0.0,1.0
1484,Kill Zone 2,93638358,11998,93626360,2015.csv,2015,0.00012813125151126635,0.9998718687484888
1485,The Lovely Bones,93621340,44114232,49507108,2009.csv,2009,0.47119846821248235,0.5288015317875177
1486,The Internship,93492844,44672764,48820080,2013.csv,2013,0.4778201420421011,0.5221798579578989
1487,Everything Everywhere All at Once,93451568,67712953,25738615,2022.csv,2022,0.7245780295521633,0.2754219704478367
1488,BlacKkKlansman,93400823,49275340,44125483,2018.csv,2018,0.5275685847008008,0.47243141529919924
1489,Calendar Girls,93400759,31041759,62359000,2003.csv,2003,0.3323501792956522,0.6676498207043479
1490,Goosebumps 2: Slappy's Revenge,93320380,46700633,46619747,2018.csv,2018,0.5004333780038187,0.49956662199618135
1491,Money Monster,93282604,41012075,52270529,2016.csv,2016,0.43965405382551287,0.5603459461744872
1492,Nanny McPhee Returns,93251121,29011215,64239906,2010.csv,2010,0.3111084852266816,0.6888915147733183
1493,Michael Clayton,92991835,49033882,43957953,2007.csv,2007,0.5272923370100181,0.47270766298998185
1494,Deuce Bigalow: Male Gigolo,92938755,65538755,27400000,1999.csv,1999,0.7051821922942695,0.2948178077057305
1495,Secret Window,92913171,48022900,44890271,2004.csv,2004,0.5168578306298469,0.48314216937015314
1496,The Family Stone,92884429,60062868,32821561,2005.csv,2005,0.646640870236711,0.353359129763289
1497,House of Flying Daggers,92863945,11050094,81813851,2004.csv,2004,0.11899229566437222,0.8810077043356278
1498,Train to Busan,92742323,2129768,90612555,2016.csv,2016,0.022964359001445327,0.9770356409985547
1499,Role Models,92649419,67294270,25355149,2008.csv,2008,0.7263323475347427,0.2736676524652572
1500,No Reservations,92601050,43107979,49493071,2007.csv,2007,0.4655236522696017,0.5344763477303983
1501,Four Brothers,92374674,74494381,17880293,2005.csv,2005,0.806437281716415,0.19356271828358496
1502,Evangelion: 3.0+1.01 Thrice Upon a Time,92246218,0,92246218,2021.csv,2021,0.0,1.0
1503,Downfall,92181574,5509040,86672534,2004.csv,2004,0.059762919648128375,0.9402370803518716
1504,Underworld: Rise of the Lycans,92158961,45802315,46356646,2009.csv,2009,0.4969925279431047,0.5030074720568952
1505,Fracture,92011561,39015018,52996543,2007.csv,2007,0.42402299858818826,0.5759770014118117
1506,"I Love You, Man",91980359,71440011,20540348,2009.csv,2009,0.7766876730715957,0.22331232692840436
1507,Southpaw,91970827,52421953,39548874,2015.csv,2015,0.5699845778270538,0.4300154221729462
1508,Brave Hearts: Umizaru,91884352,0,91884352,2012.csv,2012,0.0,1.0
1509,End Game,91824961,23149,91801812,2021.csv,2021,0.00025209920862367697,0.9997479007913763
1510,Behind Enemy Lines,91753202,58856790,32896412,2001.csv,2001,0.6414685124558378,0.3585314875441622
1511,Get Him to the Greek,91720255,60974475,30745780,2010.csv,2010,0.6647874561622185,0.33521254383778154
1512,Shadow,91708374,521396,91186978,2018.csv,2018,0.005685369582498541,0.9943146304175015
1513,Season of the Witch,91627228,24827228,66800000,2011.csv,2011,0.2709590647007241,0.7290409352992759
1514,Crawl,91542097,39014193,52527904,2019.csv,2019,0.4261885436161682,0.5738114563838318
1515,Five Feet Apart,91522094,45729221,45792873,2019.csv,2019,0.49965225883052894,0.500347741169471
1516,Friday the 13th,91509154,65002019,26507135,2009.csv,2009,0.7103335148306583,0.2896664851693416
1517,Rambo: Last Blood,91490353,44819352,46671001,2019.csv,2019,0.4898806325514997,0.5101193674485003
1518,Overboard,91244913,50316123,40928790,2018.csv,2018,0.551440308787406,0.448559691212594
1519,White Noise,91196419,56386759,34809660,2005.csv,2005,0.6183001440001717,0.38169985599982825
1520,Romeo Must Die,91036760,55973336,35063424,2000.csv,2000,0.6148432347548397,0.3851567652451603
1521,Final Destination 2,90941129,46961214,43979915,2003.csv,2003,0.5163913678705264,0.4836086321294736
1522,Paranormal Activity: The Marked Ones,90894962,32462372,58432590,2014.csv,2014,0.35714159823291414,0.6428584017670859
1523,Fantasia 2000,90874570,60655420,30219150,2000.csv,2000,0.667463075753756,0.33253692424624404
1524,Drag Me to Hell,90842646,42100625,48742021,2009.csv,2009,0.4634456046117371,0.5365543953882629
1525,Racing Stripes,90754475,49772522,40981953,2005.csv,2005,0.5484304988817356,0.45156950111826444
1526,Autumn in New York,90726668,37761915,52964753,2000.csv,2000,0.4162162662030088,0.5837837337969912
1527,Galaxy Quest,90683916,71583916,19100000,1999.csv,1999,0.7893783060713876,0.21062169392861244
1528,Anchorman: The Legend of Ron Burgundy,90649730,85288303,5361427,2004.csv,2004,0.9408555657032845,0.0591444342967155
1529,My Big Fat Greek Wedding 2,90632641,59689605,30943036,2016.csv,2016,0.6585883887020351,0.34141161129796493
1530,Madea Goes to Jail,90508336,90508336,0,2009.csv,2009,1.0,0.0
1531,Sherlock Gnomes,90497778,43242871,47254907,2018.csv,2018,0.4778335110062039,0.522166488993796
1532,Bring It On,90449929,68379000,22070929,2000.csv,2000,0.7559873264245459,0.24401267357545411
1533,Bedazzled,90383208,37886980,52496228,2000.csv,2000,0.4191816249761792,0.5808183750238208
1534,Jojo Rabbit,90335025,33370906,56964119,2019.csv,2019,0.369412705647671,0.630587294352329
1535,Red Riding Hood,90260376,37662162,52598214,2011.csv,2011,0.4172613019028416,0.5827386980971584
1536,Identity,90259536,52159536,38100000,2003.csv,2003,0.5778839368285695,0.42211606317143047
1537,Old,90146510,48276510,41870000,2021.csv,2021,0.5355338770186444,0.4644661229813556
1538,Detective Dee: The Four Heavenly Kings,90040771,262963,89777808,2018.csv,2018,0.0029204880975530517,0.9970795119024469
1539,Downton Abbey: A New Era,89801895,43896550,45905345,2022.csv,2022,0.4888154086280696,0.5111845913719304
1540,Sucker Punch,89792502,36392502,53400000,2011.csv,2011,0.4052955557469598,0.5947044442530401
1541,Burlesque,89519773,39440655,50079118,2010.csv,2010,0.4405803732321797,0.5594196267678203
1542,The Hundred-Foot Journey,89514453,54240821,35273632,2014.csv,2014,0.6059448411085079,0.39405515889149206
1543,Stigmata,89446268,50046268,39400000,1999.csv,1999,0.5595120860716067,0.4404879139283933
1544,The Host,89431890,2201923,87229967,2006.csv,2006,0.024621228512558553,0.9753787714874415
1545,The Purge,89328627,64473115,24855512,2013.csv,2013,0.7217519978226017,0.2782480021773983
1546,The Last Song,89137047,62950384,26186663,2010.csv,2010,0.7062202094265025,0.29377979057349746
1547,K.G.F: Chapter 2,89123940,2874000,86249940,2022.csv,2022,0.032247227849217616,0.9677527721507824
1548,Transporter 2,89083229,43095856,45987373,2005.csv,2005,0.4837706994208753,0.5162293005791248
1549,Rumor Has It...,88933562,43000262,45933300,2005.csv,2005,0.4835099486963088,0.5164900513036912
1550,Kangaroo Jack,88929111,66934963,21994148,2003.csv,2003,0.7526777480098727,0.24732225199012728
1551,The Inbetweeners,88823111,36000,88787111,2011.csv,2011,0.00040529992244923735,0.9995947000775508
1552,The Cider House Rules,88545092,57545092,31000000,1999.csv,1999,0.6498958971096896,0.3501041028903104
1553,Collateral Beauty,88528280,31016021,57512259,2016.csv,2016,0.350351559976089,0.649648440023911
1554,Shanghai Knights,88323487,60476872,27846615,2003.csv,2003,0.6847201582971922,0.31527984170280776
1555,Line Walker,88228755,0,88228755,2016.csv,2016,0.0,1.0
1556,This Is 40,88215156,67544505,20670651,2012.csv,2012,0.7656791424820469,0.23432085751795304
1557,Rookies the Movie: Graduation,88055243,0,88055243,2009.csv,2009,0.0,1.0
1558,Dhoom 3,88031955,8031955,80000000,2013.csv,2013,0.09123908471645324,0.9087609152835467
1559,Chasing the Dragon,87965942,456854,87509088,2017.csv,2017,0.005193532742478902,0.9948064672575211
1560,Deliver Us from Evil,87937815,30577122,57360693,2014.csv,2014,0.3477130060600209,0.652286993939979
1561,The Illusionist,87892388,39868642,48023746,2006.csv,2006,0.45360745005585695,0.5463925499441431
1562,State of Play,87812371,37017955,50794416,2009.csv,2009,0.42155740220247556,0.5784425977975245
1563,Serial (Bad) Weddings 2,87761988,0,87761988,2019.csv,2019,0.0,1.0
1564,Gosford Park,87754044,41308615,46445429,2001.csv,2001,0.47073175339930773,0.5292682466006923
1565,Ali,87713825,58203105,29510720,2001.csv,2001,0.6635567996265127,0.3364432003734873
1566,RV,87528173,71726025,15802148,2006.csv,2006,0.819462151917646,0.180537848082354
1567,Bicentennial Man,87423861,58223861,29200000,1999.csv,1999,0.6659950765615351,0.33400492343846494
1568,Tiger Zinda Hai,87320000,5560921,81759079,2017.csv,2017,0.06368439074667888,0.9363156092533211
1569,Pain & Gain,87305549,49875291,37430258,2013.csv,2013,0.5712728637672274,0.42872713623277253
1570,Sultan,87280000,6200000,81080000,2016.csv,2016,0.07103574702108158,0.9289642529789184
1571,Epic Movie,87238158,39739367,47498791,2007.csv,2007,0.4555273507723535,0.5444726492276465
1572,A Million Ways to Die in the West,87189756,43139300,44050456,2014.csv,2014,0.49477486781818725,0.5052251321818128
1573,Old School,87135520,75585093,11550427,2003.csv,2003,0.8674429555249111,0.13255704447508893
1574,The Shaggy Dog,87134280,61123569,26010711,2006.csv,2006,0.701487049643378,0.298512950356622
1575,The Thieves,87126367,685839,86440528,2012.csv,2012,0.007871773191231536,0.9921282268087684
1576,About Time,87100449,15322921,71777528,2013.csv,2013,0.17592241114623874,0.8240775888537613
1577,American Dreams in China,87097067,0,87097067,2013.csv,2013,0.0,1.0
1578,Max Payne,87066930,40689393,46377537,2008.csv,2008,0.46733464703533245,0.5326653529646675
1579,The Kingdom,87019158,47536778,39482380,2007.csv,2007,0.5462794526235246,0.45372054737647544
1580,The Tale of Despereaux,86957280,50877145,36080135,2008.csv,2008,0.5850820655843881,0.4149179344156119
1581,"Hello, Mrs. Money",86874070,0,86874070,2018.csv,2018,0.0,1.0
1582,Dinner for Schmucks,86855739,73026337,13829402,2010.csv,2010,0.8407773376955552,0.15922266230444485
1583,Snowpiercer,86758912,4563650,82195262,2013.csv,2013,0.052601512568530136,0.9473984874314698
1584,The Lincoln Lawyer,86752352,58009200,28743152,2011.csv,2011,0.6686758187259292,0.3313241812740708
1585,Robin Hood,86489031,30824628,55664403,2018.csv,2018,0.35639927564918605,0.643600724350814
1586,Tears of the Sun,86468162,43734876,42733286,2003.csv,2003,0.5057916693082941,0.49420833069170594
1587,Sky High,86369815,63946815,22423000,2005.csv,2005,0.7403838366447815,0.2596161633552185
1588,La Vie en Rose,86274793,10301706,75973087,2007.csv,2007,0.11940574577791221,0.8805942542220878
1589,A Taxi Driver,86252940,1527829,84725111,2017.csv,2017,0.01771335562590678,0.9822866443740932
1590,War Dogs,86234523,43034523,43200000,2016.csv,2016,0.4990405408747956,0.5009594591252045
1591,Step Up All In,86165646,14904384,71261262,2014.csv,2014,0.1729736233858213,0.8270263766141787
1592,Hall Pass,86157237,45060734,41096503,2011.csv,2011,0.523005792305062,0.47699420769493805
1593,I Can Only Imagine,86086881,83482352,2604529,2018.csv,2018,0.9697453436604353,0.030254656339564676
1594,John Wick,86013056,43037835,42975221,2014.csv,2014,0.5003639796265348,0.49963602037346516
1595,The Second Best Exotic Marigold Hotel,85978266,33078266,52900000,2015.csv,2015,0.38472822887588826,0.6152717711241118
1596,Meet the Spartans,85897593,38233676,47663917,2008.csv,2008,0.4451076527837049,0.5548923472162951
1597,Date Movie,85749034,48548426,37200608,2006.csv,2006,0.5661687803969897,0.43383121960301035
1598,Match Point,85638656,23151529,62487127,2005.csv,2005,0.2703397050042448,0.7296602949957552
1599,Volver,85585177,12899867,72685310,2006.csv,2006,0.15072548135292166,0.8492745186470784
1600,Spy Kids 4: All the Time in the World,85564310,38538188,47026122,2011.csv,2011,0.45040026618574963,0.5495997338142503
1601,Paper Towns,85512300,32000304,53511996,2015.csv,2015,0.37421872642882953,0.6257812735711704
1602,Rat Race,85498534,56618055,28880479,2001.csv,2001,0.6622108280827365,0.33778917191726354
1603,The Possession,85446075,49130154,36315921,2012.csv,2012,0.5749843278348362,0.42501567216516384
1604,Big Fish & Begonia,85409373,0,85409373,2016.csv,2016,0.0,1.0
1605,Bayside Shakedown 3: Set the Guys Loose,85347374,0,85347374,2010.csv,2010,0.0,1.0
1606,Did You Hear About the Morgans?,85280250,29580087,55700163,2009.csv,2009,0.34685741423131383,0.6531425857686862
1607,Nerve,85251425,38583626,46667799,2016.csv,2016,0.4525862881470896,0.5474137118529103
1608,Hidden Man,85170581,0,85170581,2018.csv,2018,0.0,1.0
1609,Final Fantasy: The Spirits Within,85131830,32131830,53000000,2001.csv,2001,0.3774361481481133,0.6225638518518867
1610,J. Edgar,84920539,37306030,47614509,2011.csv,2011,0.4393051485459837,0.5606948514540163
1611,Going in Style,84918541,45018541,39900000,2017.csv,2017,0.5301379471416025,0.46986205285839755
1612,Sicario,84872444,46889293,37983151,2015.csv,2015,0.5524678068655593,0.44753219313444065
1613,Carrie,84790678,35266619,49524059,2013.csv,2013,0.41592566343201076,0.5840743365679892
1614,Zodiac,84785914,33080084,51705830,2007.csv,2007,0.39016013910046426,0.6098398608995358
1615,The Animal,84772742,57743062,27029680,2001.csv,2001,0.6811512832745223,0.31884871672547765
1616,Jackass Number Two,84645164,72778712,11866452,2006.csv,2006,0.8598094511341486,0.14019054886585133
1617,Never Been Kissed,84565230,55474756,29090474,1999.csv,1999,0.6559995875373366,0.34400041246266344
1618,The Judge,84419388,47119388,37300000,2014.csv,2014,0.5581583699706517,0.44184163002934823
1619,Mortal Kombat,84416731,42326031,42090700,2021.csv,2021,0.5013938646830567,0.49860613531694326
1620,What to Expect When You're Expecting,84384002,41152203,43231799,2012.csv,2012,0.4876777828100639,0.5123222171899361
1621,Nights in Rodanthe,84375346,41850659,42524687,2008.csv,2008,0.4960057763792755,0.5039942236207244
1622,Dog,84372107,61778069,22594038,2022.csv,2022,0.7322096270512718,0.2677903729487282
1623,Leap!,84197417,2844490,81352927,2016.csv,2016,0.0337835779451524,0.9662164220548476
1624,French Fried Vacation 3: Friends Forever,84152064,0,84152064,2006.csv,2006,0.0,1.0
1625,Premonition,84146832,47852604,36294228,2007.csv,2007,0.5686798048439898,0.43132019515601017
1626,Finding Mr. Right,84112033,6945,84105088,2013.csv,2013,8.256844772733052e-05,0.9999174315522726
1627,Our Times,83867493,0,83867493,2015.csv,2015,0.0,1.0
1628,Pan's Labyrinth,83850267,37634615,46215652,2006.csv,2006,0.4488311885757024,0.5511688114242975
1629,Marmaduke,83761844,33644788,50117056,2010.csv,2010,0.40167200712534457,0.5983279928746554
1630,In Her Shoes,83697473,32880591,50816882,2005.csv,2005,0.3928504627612831,0.6071495372387169
1631,Mortal Engines,83672673,15951040,67721633,2018.csv,2018,0.19063619492591088,0.8093638050740891
1632,Snatch,83557872,30328156,53229716,2000.csv,2000,0.3629598896439105,0.6370401103560895
1633,Blow,83282296,52990775,30291521,2001.csv,2001,0.6362789877935162,0.36372101220648384
1634,Piranha 3D,83188165,25003155,58185010,2010.csv,2010,0.30056144404675833,0.6994385559532417
1635,"South Park: Bigger, Longer & Uncut",83137603,52037603,31100000,1999.csv,1999,0.6259213775985338,0.37407862240146617
1636,Oceans,83090556,19422319,63668237,2010.csv,2010,0.23374881496761196,0.766251185032388
1637,Rings,83080890,27793018,55287872,2017.csv,2017,0.33452961324800445,0.6654703867519955
1638,Suck Me Shakespeer 2,83027924,0,83027924,2015.csv,2015,0.0,1.0
1639,Savages,82966152,47382068,35584084,2012.csv,2012,0.5711011883496778,0.4288988116503222
1640,Once Upon A Time,82886178,485728,82400450,2017.csv,2017,0.005860180933906736,0.9941398190660933
1641,The Fighter Pilot,82879386,0,82879386,2013.csv,2013,0.0,1.0
1642,Firewall,82751189,48751189,34000000,2006.csv,2006,0.5891297706912707,0.41087022930872935
1643,28 Days Later...,82719885,45064915,37654970,2002.csv,2002,0.5447893816583521,0.45521061834164783
1644,"Big Mommas: Like Father, Like Son",82686066,37915414,44770652,2011.csv,2011,0.4585465947793429,0.5414534052206571
1645,Sinister,82515113,48086903,34428210,2012.csv,2012,0.5827647960683275,0.4172352039316725
1646,Act of Valor,82497035,70012847,12484188,2012.csv,2012,0.8486710704208945,0.1513289295791055
1647,The Constant Gardener,82466670,33579797,48886873,2005.csv,2005,0.4071923481328881,0.5928076518671119
1648,The Strangers,82410456,52597610,29812846,2008.csv,2008,0.6382395214510159,0.36176047854898413
1649,Hitman: Agent 47,82347656,22467450,59880206,2015.csv,2015,0.2728365455842483,0.7271634544157517
1650,Men of Honor,82343495,48818921,33524574,2000.csv,2000,0.5928691877846575,0.4071308122153426
1651,Tiny Times 3.0,82320000,0,82320000,2014.csv,2014,0.0,1.0
1652,Blades of Blood 2010 Re-release,82177196,0,82177196,2010.csv,2010,0.0,1.0
1653,Hannibal Rising,82169884,27670986,54498898,2007.csv,2007,0.33675337791641524,0.6632466220835848
1654,Reign of Fire,82150183,43061982,39088201,2002.csv,2002,0.5241860751545739,0.4758139248454261
1655,Catwoman,82102379,40202379,41900000,2004.csv,2004,0.48966156023323026,0.5103384397667697
1656,Miracle in Cell No. 7,82101723,0,82101723,2013.csv,2013,0.0,1.0
1657,Abduction,82087155,28087155,54000000,2011.csv,2011,0.34216260753585626,0.6578373924641437
1658,The Chorus,82032134,2087128,79945006,2004.csv,2004,0.025442810009063035,0.974557189990937
1659,Hostel,81979826,47326473,34653353,2006.csv,2006,0.5772941381944382,0.4227058618055618
1660,Rabbit Without Ears,81744033,0,81744033,2007.csv,2007,0.0,1.0
1661,Ouija: Origin of Evil,81705746,35144505,46561241,2016.csv,2016,0.43013504827432825,0.5698649517256718
1662,One Piece: Stampede,81562741,1298528,80264213,2019.csv,2019,0.01592060276640286,0.9840793972335972
1663,Frankenweenie,81491068,35291068,46200000,2012.csv,2012,0.43306670124877983,0.5669332987512202
1664,Wolf Warrior,81411331,0,81411331,2015.csv,2015,0.0,1.0
1665,Gone with the Bullets,81387479,0,81387479,2014.csv,2014,0.0,1.0
1666,Tinker Tailor Soldier Spy,81244605,24149393,57095212,2011.csv,2011,0.297243035399089,0.7027569646009111
1667,Edge of Darkness,81126522,43313890,37812632,2010.csv,2010,0.5339054224461884,0.46609457755381156
1668,iPartment the Movie,81096321,0,81096321,2018.csv,2018,0.0,1.0
1669,Underworld: Blood Wars,81093313,30353973,50739340,2016.csv,2016,0.37430919858953104,0.625690801410469
1670,Doraemon the Movie: Nobita's Treasure Island,80920916,0,80920916,2018.csv,2018,0.0,1.0
1671,Sinbad: Legend of the Seven Seas,80773077,26483452,54289625,2003.csv,2003,0.32787474469989547,0.6721252553001045
1672,Hot Fuzz,80743363,23637265,57106098,2007.csv,2007,0.292745609320236,0.707254390679764
1673,A Dog's Way Home,80708134,42004346,38703788,2019.csv,2019,0.5204474929379485,0.4795525070620515
1674,The Rookie,80693537,75600072,5093465,2002.csv,2002,0.9368788977486512,0.06312110225134883
1675,The Rundown,80657921,47726342,32931579,2003.csv,2003,0.5917130197293332,0.4082869802706668
1676,Go Away Mr. Tumor,80606893,286639,80320254,2015.csv,2015,0.0035560110225312867,0.9964439889774687
1677,Vampires Suck,80547866,36661504,43886362,2010.csv,2010,0.4551517727359779,0.5448482272640222
1678,Caught in Time,80543319,0,80543319,2020.csv,2020,0.0,1.0
1679,Den of Thieves,80509622,44947622,35562000,2018.csv,2018,0.5582888216764947,0.44171117832350526
1680,Halloween,80460948,58272029,22188919,2007.csv,2007,0.7242274724379335,0.2757725275620665
1681,Muppets Most Wanted,80383113,51183113,29200000,2014.csv,2014,0.6367396221641727,0.36326037783582726
1682,Jackass Forever,80340218,57743451,22596767,2022.csv,2022,0.718736548611307,0.281263451388693
1683,Hereditary,80200936,44069456,36131480,2018.csv,2018,0.5494880508626483,0.4505119491373517
1684,Runaway Jury,80154140,49443628,30710512,2003.csv,2003,0.6168568211199073,0.3831431788800928
1685,Finding Forrester,80049764,51804714,28245050,2000.csv,2000,0.6471563613854002,0.3528436386145998
1686,Exit Wounds,79958599,51758599,28200000,2001.csv,2001,0.6473174823886046,0.35268251761139535
1687,The Wedding Ringer,79799880,64460211,15339669,2015.csv,2015,0.8077732823658381,0.19222671763416185
1688,The Grey,79781695,51580236,28201459,2012.csv,2012,0.6465171741462751,0.353482825853725
1689,Jackass: The Movie,79493831,64255312,15238519,2002.csv,2002,0.8083056407232405,0.19169435927675949
1690,Good Bye Lenin!,79316957,4064200,75252757,2003.csv,2003,0.05123998894713018,0.9487600110528698
1691,Letters to Juliet,79293444,53032453,26260991,2010.csv,2010,0.6688125817816666,0.3311874182183334
1692,Stealth,79268322,32116746,47151576,2005.csv,2005,0.40516495353591564,0.5948350464640844
1693,Paradox,79226860,0,79226860,2017.csv,2017,0.0,1.0
1694,Manchester by the Sea,78988148,47695371,31292777,2016.csv,2016,0.603829463124012,0.396170536875988
1695,Lady Bird,78965611,48958273,30007338,2017.csv,2017,0.6199948608008617,0.3800051391991382
1696,Paranormal Activity: The Ghost Dimension,78903124,18300124,60603000,2015.csv,2015,0.2319315519116835,0.7680684480883165
1697,The Boss,78844582,63285885,15558697,2016.csv,2016,0.8026662504216207,0.1973337495783794
1698,The Sentinel,78810595,36280697,42529898,2006.csv,2006,0.4603530400956876,0.5396469599043123
1699,Code Blue: The Movie,78778562,0,78778562,2018.csv,2018,0.0,1.0
1700,Spanish Affair,78768613,0,78768613,2014.csv,2014,0.0,1.0
1701,The Orphanage,78638987,7161284,71477703,2007.csv,2007,0.09106531344306355,0.9089346865569364
1702,Curse of the Golden Flower,78568977,6566773,72002204,2006.csv,2006,0.08357971874827898,0.916420281251721
1703,The Attorney,78547586,557236,77990350,2013.csv,2013,0.007094247301247424,0.9929057526987526
1704,Righteous Kill,78460699,40081410,38379289,2008.csv,2008,0.5108469655617012,0.48915303443829883
1705,The Family,78418811,36918811,41500000,2013.csv,2013,0.47079024189744473,0.5292097581025552
1706,Collateral Damage,78382433,40077257,38305176,2002.csv,2002,0.5113040698800457,0.4886959301199543
1707,Scary Movie V,78378744,32015787,46362957,2013.csv,2013,0.4084753769465864,0.5915246230534136
1708,R.I.P.D.,78324220,33618855,44705365,2013.csv,2013,0.4292268087700075,0.5707731912299925
1709,Priest,78309505,29137000,49172505,2011.csv,2011,0.37207488414082046,0.6279251158591795
1710,If I Stay,78274843,50474843,27800000,2014.csv,2014,0.6448411911857811,0.3551588088142189
1711,The Other Boleyn Girl,78199679,26814957,51384722,2008.csv,2008,0.3429036709984449,0.6570963290015551
1712,Duplicity,78176181,40572825,37603356,2009.csv,2009,0.518992159517232,0.481007840482768
1713,Tag,78130625,54730625,23400000,2018.csv,2018,0.7005015638874001,0.2994984361125999
1714,Head Full of Honey,78127384,0,78127384,2014.csv,2014,0.0,1.0
1715,Exorcist: The Beginning,78110021,41821986,36288035,2004.csv,2004,0.5354240783010416,0.46457592169895845
1716,Mirrors,78094714,30691439,47403275,2008.csv,2008,0.3930027709685959,0.6069972290314041
1717,The Left Ear,78015473,0,78015473,2015.csv,2015,0.0,1.0
1718,Boonie Bears: The Wild Life,77961427,0,77961427,2021.csv,2021,0.0,1.0
1719,Shin Godzilla,77947607,1918403,76029204,2016.csv,2016,0.024611441888139043,0.975388558111861
1720,Orphan,77912251,41596251,36316000,2009.csv,2009,0.5338858840055847,0.4661141159944153
1721,Tiny Times 4.0,77750000,0,77750000,2015.csv,2015,0.0,1.0
1722,Showtime,77741732,38082712,39659020,2002.csv,2002,0.4898618929663157,0.5101381070336843
1723,Tiny Times,77717014,23462,77693552,2013.csv,2013,0.0003018901369525082,0.9996981098630475
1724,The Number 23,77677553,35193167,42484386,2007.csv,2007,0.4530674003080401,0.54693259969196
1725,Suck Me Shakespeer,77676735,0,77676735,2013.csv,2013,0.0,1.0
1726,Windtalkers,77628265,40914068,36714197,2002.csv,2002,0.5270511713742411,0.47294882862575893
1727,Next,77621983,18211013,59410970,2007.csv,2007,0.23461154039313836,0.7653884596068616
1728,Hostage,77608617,34639939,42968678,2005.csv,2005,0.4463414030429121,0.5536585969570879
1729,The Haunting in Connecticut,77536359,55389516,22146843,2009.csv,2009,0.7143682875281776,0.2856317124718224
1730,Serendipity,77516304,50294317,27221987,2001.csv,2001,0.6488224335360468,0.3511775664639532
1731,The Back-up Plan,77477008,37490007,39987001,2010.csv,2010,0.48388558060992753,0.5161144193900725
1732,Candyman,77411570,61186570,16225000,2021.csv,2021,0.7904060077841077,0.20959399221589228
1733,The Lives of Others,77356942,11286112,66070830,2006.csv,2006,0.14589656349135413,0.8541034365086458
1734,Diary of a Wimpy Kid: Dog Days,77229695,49008662,28221033,2012.csv,2012,0.6345831354118386,0.3654168645881613
1735,Fame,77211836,22455510,54756326,2009.csv,2009,0.2908298929713315,0.7091701070286686
1736,Fantastica: A Boonie Bears Adventure,77151096,0,77151096,2017.csv,2017,0.0,1.0
1737,Mike and Dave Need Wedding Dates,77068246,46009673,31058573,2016.csv,2016,0.596999093504736,0.40300090649526393
1738,Barbershop,77063924,75782105,1281819,2002.csv,2002,0.983366808573101,0.01663319142689905
1739,The Forever Purge,76994245,44539245,32455000,2021.csv,2021,0.5784749886176558,0.4215250113823442
1740,Drive,76976666,35061555,41915111,2011.csv,2011,0.45548289919441304,0.544517100805587
1741,"I, Frankenstein",76801179,19075290,57725889,2014.csv,2014,0.248372358971208,0.751627641028792
1742,United 93,76700659,31483450,45217209,2006.csv,2006,0.4104717014230608,0.5895282985769392
1743,Sanju,76693052,7909317,68783735,2018.csv,2018,0.10312951165380665,0.8968704883461933
1744,Coach Carter,76669554,67264877,9404677,2005.csv,2005,0.8773349196735903,0.12266508032640962
1745,The Ladykillers,76665191,39799191,36866000,2004.csv,2004,0.519129874730241,0.480870125269759
1746,The Book Thief,76586316,21488481,55097835,2013.csv,2013,0.28057859578987976,0.7194214042101202
1747,Bend It Like Beckham,76583333,32543449,44039884,2002.csv,2002,0.4249416645264055,0.5750583354735945
1748,The Unborn,76514050,42670410,33843640,2009.csv,2009,0.5576807135421533,0.4423192864578466
1749,Bad Santa,76488889,60060328,16428561,2003.csv,2003,0.7852163730604061,0.2147836269395938
1750,The Road to El Dorado,76432727,50863742,25568985,2000.csv,2000,0.665470721723693,0.33452927827630696
1751,Cold Pursuit,76419755,32138862,44280893,2019.csv,2019,0.42055698817668286,0.5794430118233171
1752,(T)Raumschiff Surprise - Periode 1,76341401,0,76341401,2004.csv,2004,0.0,1.0
1753,The Ides of March,76338111,40962534,35375577,2011.csv,2011,0.5365934978401549,0.4634065021598452
1754,Tae Guk Gi: The Brotherhood of War,76287982,1111061,75176921,2004.csv,2004,0.01456403709826798,0.985435962901732
1755,Kubo and the Two Strings,76249438,48023088,28226350,2016.csv,2016,0.6298156322148892,0.37018436778511077
1756,Diary of a Wimpy Kid,76196538,64003625,12192913,2010.csv,2010,0.8399807482066968,0.16001925179330326
1757,There Will Be Blood,76181545,40222514,35959031,2007.csv,2007,0.5279823873354105,0.4720176126645896
1758,The Mechanic,76130093,29121498,47008595,2011.csv,2011,0.38252282182290254,0.6174771781770975
1759,Hero,76089199,0,76089199,2007.csv,2007,0.0,1.0
1760,If You Are the One 2,76085443,426894,75658549,2010.csv,2010,0.005610718465554574,0.9943892815344454
1761,Vice,76073488,47836282,28237206,2018.csv,2018,0.6288167304751426,0.3711832695248573
1762,The Pink Panther 2,76025134,35922978,40102156,2009.csv,2009,0.4725144976396885,0.5274855023603116
1763,Kate & Leopold,76019048,47121859,28897189,2001.csv,2001,0.6198691017546023,0.38013089824539764
1764,West Side Story,76016171,38530322,37485849,2021.csv,2021,0.5068700711063177,0.49312992889368235
1765,Death Race,76014335,36316032,39698303,2008.csv,2008,0.47775241340991803,0.522247586590082
1766,Widows,75984700,42402632,33582068,2018.csv,2018,0.5580417110286676,0.4419582889713324
1767,Revolutionary Road,75981180,22911480,53069700,2008.csv,2008,0.3015415133063214,0.6984584866936786
1768,Cruel Intentions,75902208,38328567,37573641,1999.csv,1999,0.5049730173857393,0.4950269826142607
1769,Quo vado?,75878701,0,75878701,2016.csv,2016,0.0,1.0
1770,Sicario: Day of the Soldado,75837743,50072235,25765508,2018.csv,2018,0.6602548153364743,0.33974518466352566
1771,Elizabeth: The Golden Age,75782758,16383509,59399249,2007.csv,2007,0.21619045588179833,0.7838095441182017
1772,A Dog's Journey,75741734,22782371,52959363,2019.csv,2019,0.30079019579879174,0.6992098042012083
1773,Dreamcatcher,75715436,33715436,42000000,2003.csv,2003,0.44529144625146183,0.5547085537485381
1774,Bajrangi Bhaijaan,75547184,8178001,67369183,2015.csv,2015,0.10825024265629808,0.8917497573437019
1775,30 Days of Night,75513170,39569000,35944170,2007.csv,2007,0.5240013099701681,0.47599869002983186
1776,Stomp the Yard,75511123,61356221,14154902,2007.csv,2007,0.8125454709500215,0.1874545290499785
1777,Der Schuh des Manitu,75482094,0,75482094,2001.csv,2001,0.0,1.0
1778,Searching,75462037,26020957,49441080,2018.csv,2018,0.3448218208050758,0.6551781791949242
1779,The Change-Up,75450437,37081475,38368962,2011.csv,2011,0.49146799507602584,0.5085320049239741
1780,The Count of Monte Cristo,75395048,54234062,21160986,2002.csv,2002,0.719331885033086,0.280668114966914
1781,The Spy Who Dumped Me,75320680,33562069,41758611,2018.csv,2018,0.4455890334500432,0.5544109665499568
1782,1921,75159828,0,75159828,2021.csv,2021,0.0,1.0
1783,Dragon Wars: D-War,75108817,10977721,64131096,2007.csv,2007,0.1461575543121655,0.8538424456878345
1784,Larry Crowne,75055070,35608245,39446825,2011.csv,2011,0.47442824315532584,0.5255717568446742
1785,Easy A,75026216,58401464,16624752,2010.csv,2010,0.7784140946146078,0.22158590538539222
1786,The Kite Runner,75011029,15800078,59210951,2007.csv,2007,0.21063673183312817,0.7893632681668719
1787,Animal World,74922830,0,74922830,2018.csv,2018,0.0,1.0
1788,Boo! A Madea Halloween,74827344,73206343,1621001,2016.csv,2016,0.9783367828744529,0.021663217125547047
1789,A Madea Family Funeral,74747725,73257045,1490680,2019.csv,2019,0.9800571856869222,0.019942814313077754
1790,Crimson Peak,74679822,31090320,43589502,2014.csv,2014,0.4163148648104705,0.5836851351895295
1791,Random Hearts,74608570,31502583,43105987,1999.csv,1999,0.42223812894416823,0.5777618710558318
1792,Escape from Planet Earth,74597643,57012977,17584666,2013.csv,2013,0.7642731687916735,0.23572683120832652
1793,From Hell,74558115,31602566,42955549,2001.csv,2001,0.4238648737297074,0.5761351262702926
1794,The King and the Clown,74466867,0,74466867,2005.csv,2005,0.0,1.0
1795,Thermae Romae,74285251,0,74285251,2012.csv,2012,0.0,1.0
1796,Hubble,74249729,52522904,21726825,2010.csv,2010,0.7073817602755156,0.29261823972448436
1797,One Piece Film Z,74223861,0,74223861,2012.csv,2012,0.0,1.0
1798,August: Osage County,74188937,37738810,36450127,2013.csv,2013,0.5086851426379111,0.4913148573620889
1799,Eternal Sunshine of the Spotless Mind,74036715,34400301,39636414,2004.csv,2004,0.4646384027168142,0.5353615972831858
1800,Miracles from Heaven,73983003,61705123,12277880,2016.csv,2016,0.8340445845378837,0.16595541546211634
1801,The Hurricane,73956241,50699241,23257000,1999.csv,1999,0.6855302583591288,0.3144697416408711
1802,Divine Secrets of the Ya-Ya Sisterhood,73839240,69599016,4240224,2002.csv,2002,0.94257492357722,0.05742507642278008
1803,Cats,73833348,27166770,46666578,2019.csv,2019,0.3679471503852162,0.6320528496147838
1804,Obsessed,73830347,68261644,5568703,2009.csv,2009,0.9245743352662287,0.07542566473377132
1805,Crying Out Love in the Center of the World,73611055,0,73611055,2004.csv,2004,0.0,1.0
1806,Perfect Stranger,73534117,23984949,49549168,2007.csv,2007,0.3261744341065522,0.6738255658934478
1807,The Core,73498611,31186896,42311715,2003.csv,2003,0.4243195289772211,0.575680471022779
1808,Life,73475268,64016268,9459000,1999.csv,1999,0.8712628036960682,0.12873719630393182
1809,Charlie's Angels,73279888,17803077,55476811,2019.csv,2019,0.24294629107511737,0.7570537089248827
1810,War Room,73267874,67790117,5477757,2015.csv,2015,0.9252365777666758,0.07476342223332426
1811,To Rome with Love,73244881,16685867,56559014,2012.csv,2012,0.22780932636097806,0.7721906736390219
1812,"Dude, Where's My Car?",73180723,46729800,26450923,2000.csv,2000,0.6385534070222291,0.36144659297777093
1813,Here Comes the Boom,73100172,45290318,27809854,2012.csv,2012,0.6195651359069305,0.3804348640930694
1814,My Old Classmate,73052128,0,73052128,2014.csv,2014,0.0,1.0
1815,Without a Paddle,73029190,58169327,14859863,2004.csv,2004,0.7965215963644127,0.20347840363558736
1816,Bayside Shakedown the Final,72867395,0,72867395,2012.csv,2012,0.0,1.0
1817,The Best Man Holiday,72835710,70525195,2310515,2013.csv,2013,0.9682777170703766,0.0317222829296234
1818,Lady in the Water,72785169,42285169,30500000,2006.csv,2006,0.580958587868361,0.4190414121316391
1819,The Bélier Family,72751538,0,72751538,2014.csv,2014,0.0,1.0
1820,The One,72689126,43905746,28783380,2001.csv,2001,0.6040208269941229,0.3959791730058771
1821,"Yours, Mine & Ours",72662923,53412862,19250061,2005.csv,2005,0.7350772552874043,0.26492274471259575
1822,The Transporter Refueled,72629670,16029670,56600000,2015.csv,2015,0.22070415575342694,0.779295844246573
1823,Lord of War,72617068,24149632,48467436,2005.csv,2005,0.3325613752403223,0.6674386247596777
1824,Diary of a Wimpy Kid: Rodrick Rules,72526996,52698535,19828461,2011.csv,2011,0.7266057868989914,0.27339421310100864
1825,Amazing China,72506343,0,72506343,2018.csv,2018,0.0,1.0
1826,Doctor Sleep,72381712,31581712,40800000,2019.csv,2019,0.4363217051290525,0.5636782948709476
1827,Second Act,72282227,39282227,33000000,2018.csv,2018,0.5434562357908536,0.45654376420914644
1828,Boys Over Flowers: Final,72243609,0,72243609,2008.csv,2008,0.0,1.0
1829,What Men Want,72216294,54611903,17604391,2019.csv,2019,0.7562268841987377,0.24377311580126224
1830,Around the World in 80 Days,72178895,24008137,48170758,2004.csv,2004,0.33261990225813237,0.6673800977418676
1831,Babylon A.D.,72109200,22532572,49576628,2008.csv,2008,0.3124784632196724,0.6875215367803276
1832,The Adventures of Sharkboy and Lavagirl 3-D,71992655,39177684,32814971,2005.csv,2005,0.5441900149397185,0.4558099850602815
1833,"O Brother, Where Art Thou?",71868327,45512588,26355739,2000.csv,2000,0.6332774102282915,0.36672258977170846
1834,Rules of Engagement,71732303,61335230,10397073,2000.csv,2000,0.8550573093965769,0.14494269060342313
1835,Funny People,71585235,51855045,19730190,2009.csv,2009,0.7243818505310488,0.27561814946895125
1836,Run All Night,71561644,26461644,45100000,2015.csv,2015,0.3697741208963841,0.6302258791036159
1837,Superhero Movie,71538062,25881068,45656994,2008.csv,2008,0.36178039041650306,0.638219609583497
1838,The Royal Tenenbaums,71441250,52364010,19077240,2001.csv,2001,0.7329660385281612,0.2670339614718387
1839,Brick Mansions,71416730,20396829,51019901,2014.csv,2014,0.28560295325759105,0.714397046742409
1840,Holes,71406573,67406573,4000000,2003.csv,2003,0.9439827479187385,0.05601725208126148
1841,Tidal Wave,71283278,0,71283278,2009.csv,2009,0.0,1.0
1842,Down to Earth,71186502,64186502,7000000,2001.csv,2001,0.9016667513737365,0.09833324862626344
1843,Pokémon: Zoroark: Master of Illusions,71143529,0,71143529,2010.csv,2010,0.0,1.0
1844,xXx: State of the Union,71022693,26873932,44148761,2005.csv,2005,0.37838514515353566,0.6216148548464644
1845,The Counselor,71009334,16973715,54035619,2013.csv,2013,0.23903498376706364,0.7609650162329363
1846,Anacondas: The Hunt for the Blood Orchid,70992898,32238923,38753975,2004.csv,2004,0.45411476229636377,0.5458852377036362
1847,Son of God,70829270,59700064,11129206,2014.csv,2014,0.842872784090532,0.15712721590946793
1848,I Am Not Madame Bovary,70826207,436798,70389409,2016.csv,2016,0.006167180461887504,0.9938328195381125
1849,Taxi 2004 Re-release,70778329,36611066,34167263,2004.csv,2004,0.5172637799911891,0.4827362200088109
1850,Brotherhood of the Wolf,70752904,11260096,59492808,2001.csv,2001,0.15914676802523894,0.840853231974761
1851,The Grudge 2,70711175,39143839,31567336,2006.csv,2006,0.5535735900301473,0.4464264099698527
1852,Hannah Montana and Miley Cyrus: Best of Both Worlds Concert,70642966,65281781,5361185,2008.csv,2008,0.9241087215958628,0.07589127840413722
1853,A Turtle's Tale: Sammy's Adventures,70627617,0,70627617,2010.csv,2010,0.0,1.0
1854,Children of Men,70455770,35552383,34903387,2006.csv,2006,0.5046056980145133,0.4953943019854868
1855,Departures,70442129,1498210,68943919,2008.csv,2008,0.021268664381225617,0.9787313356187743
1856,The House Bunny,70439696,48237389,22202307,2008.csv,2008,0.6848040485580744,0.3151959514419256
1857,Spirited Away 2018 Re-release,70186029,1175067,69010962,2018.csv,2018,0.016742178133485795,0.9832578218665142
1858,Think Like a Man Too,70181428,65182182,4999246,2014.csv,2014,0.9287668241803231,0.07123317581967696
1859,License to Wed,70181325,43799818,26381507,2007.csv,2007,0.6240950566265313,0.37590494337346864
1860,A Cinderella Story,70067909,51438175,18629734,2004.csv,2004,0.7341188817265832,0.2658811182734167
1861,See You Tomorrow,70065569,0,70065569,2016.csv,2016,0.0,1.0
1862,3:10 to Yuma,70016220,53606916,16409304,2007.csv,2007,0.7656356769902746,0.23436432300972546
1863,The Hills Have Eyes,70008952,41778863,28230089,2006.csv,2006,0.5967645823351276,0.40323541766487236
1864,The Cabin in the Woods,69935600,42073277,27862323,2012.csv,2012,0.6016002865493397,0.39839971345066033
1865,Sole a catinelle,69903094,0,69903094,2013.csv,2013,0.0,1.0
1866,Curious George,69865924,58360760,11505164,2006.csv,2006,0.8353251006885702,0.1646748993114297
1867,The Brave One,69787394,36793804,32993590,2007.csv,2007,0.5272270805813439,0.472772919418656
1868,The Dilemma,69721966,48475290,21246676,2011.csv,2011,0.6952656785380952,0.3047343214619048
1869,After,69518232,12138565,57379667,2019.csv,2019,0.1746098059570905,0.8253901940429095
1870,Exit,69501772,470699,69031073,2019.csv,2019,0.006772474808268198,0.9932275251917319
1871,Because I Said So,69485490,42674040,26811450,2007.csv,2007,0.6141431829868366,0.3858568170131635
1872,Mr. Magorium's Wonder Emporium,69474661,32061555,37413106,2007.csv,2007,0.46148559112796533,0.5385144088720346
1873,The Last Exorcism,69432527,41034350,28398177,2010.csv,2010,0.5909960615433167,0.40900393845668326
1874,A Very Long Engagement,69424389,6524389,62900000,2004.csv,2004,0.0939783423949183,0.9060216576050817
1875,Playing with Fire,69412425,44451847,24960578,2019.csv,2019,0.6404018732957392,0.3595981267042608
1876,13 Hours,69411370,52853219,16558151,2015.csv,2015,0.7614490104431018,0.23855098955689824
1877,The X Files: I Want to Believe,69363381,20982478,48380903,2008.csv,2008,0.302500796493758,0.697499203506242
1878,Finding Nemo 2012 3D Release,69328283,41128283,28200000,2012.csv,2012,0.5932396017942634,0.4067603982057366
1879,E.T. the Extra-Terrestrial 20th Anniversary,69177751,35306015,33871736,2002.csv,2002,0.5103666206205518,0.4896333793794482
1880,The Men Who Stare at Goats,69095771,32428195,36667576,2009.csv,2009,0.4693224278516264,0.5306775721483736
1881,Takers,69055695,57744720,11310975,2010.csv,2010,0.8362050371080908,0.1637949628919092
1882,Anna Karenina,68929150,12816367,56112783,2012.csv,2012,0.18593536986891612,0.8140646301310839
1883,John Tucker Must Die,68844775,41011711,27833064,2006.csv,2006,0.5957127610628403,0.40428723893715973
1884,Bestseller,68813389,0,68813389,2010.csv,2010,0.0,1.0
1885,Running Man,68782475,310978,68471497,2015.csv,2015,0.004521180722269735,0.9954788192777303
1886,Land of the Lost,68777554,49438370,19339184,2009.csv,2009,0.718815472850343,0.28118452714965697
1887,House of Wax,68766121,32064800,36701321,2005.csv,2005,0.46628775236573256,0.5337122476342675
1888,The Nut Job 2: Nutty by Nature,68743485,28370522,40372963,2017.csv,2017,0.41270124725273966,0.5872987527472603
1889,The Sweetest Thing,68696770,24718164,43978606,2002.csv,2002,0.35981551971075204,0.6401844802892479
1890,Letters from Iwo Jima,68673228,13756082,54917146,2006.csv,2006,0.20031215075545888,0.7996878492445412
1891,Tales from Earthsea,68625104,0,68625104,2006.csv,2006,0.0,1.0
1892,The Call,68572631,51872378,16700253,2013.csv,2013,0.7564589143444124,0.24354108565558757
1893,The Northman,68544035,34233110,34310925,2022.csv,2022,0.4994323721969388,0.5005676278030612
1894,One Direction: This Is Us,68532898,28873374,39659524,2013.csv,2013,0.4213067715303678,0.5786932284696322
1895,Looney Tunes: Back in Action,68514844,20991364,47523480,2003.csv,2003,0.3063768779799017,0.6936231220200983
1896,Dan in Real Life,68471669,47642963,20828706,2007.csv,2007,0.6958054870840085,0.3041945129159916
1897,Thir13en Ghosts,68467960,41867960,26600000,2001.csv,2001,0.6114971148548898,0.3885028851451102
1898,Pokémon 3 the Movie: Spell of the Unown,68411275,17052128,51359147,2001.csv,2001,0.24925902930474544,0.7507409706952546
1899,Ghost Ship,68349884,30113491,38236393,2002.csv,2002,0.4405785238786945,0.5594214761213054
1900,Stalingrad,68316452,1013945,67302507,2013.csv,2013,0.014841886109659207,0.9851581138903408
1901,Open Range,68296293,58331254,9965039,2003.csv,2003,0.8540910705065646,0.1459089294934353
1902,Star Wars: The Clone Wars,68282844,35161554,33121290,2008.csv,2008,0.514939799519774,0.485060200480226
1903,The Watch,68267862,35353000,32914862,2012.csv,2012,0.5178571433802922,0.4821428566197078
1904,Moonrise Kingdom,68263166,45512466,22750700,2012.csv,2012,0.6667207026407185,0.3332792973592816
1905,Saw VI,68234154,27693292,40540862,2009.csv,2009,0.40585675027201185,0.5941432497279882
1906,Frequency,68106245,45010278,23095967,2000.csv,2000,0.6608832714239348,0.33911672857606523
1907,Fearless,68072848,24633730,43439118,2006.csv,2006,0.3618730628105937,0.6381269371894063
1908,The Yin-Yang Master: Dream of Eternity,68000000,0,68000000,2020.csv,2020,0.0,1.0
1909,Shoplifters,67999335,3313513,64685822,2018.csv,2018,0.04872860889007223,0.9512713911099278
1910,Prime,67937494,22827153,45110341,2005.csv,2005,0.33600228174445174,0.6639977182555482
1911,A Beautiful Day in the Neighborhood,67925733,61704055,6221678,2019.csv,2019,0.9084046984078921,0.09159530159210796
1912,Legion,67918658,40168080,27750578,2010.csv,2010,0.591414512342102,0.4085854876578981
1913,The American,67876281,35606376,32269905,2010.csv,2010,0.5245775913975016,0.4754224086024984
1914,All About My Mother,67872296,8272296,59600000,1999.csv,1999,0.12188030297369047,0.8781196970263095
1915,Jersey Boys,67647013,47047013,20600000,2014.csv,2014,0.6954780545890474,0.30452194541095257
1916,Bandits,67631903,41575141,26056762,2001.csv,2001,0.614726765857823,0.38527323414217696
1917,Detective Conan: The Bride of Halloween,67578120,0,67578120,2022.csv,2022,0.0,1.0
1918,The Secret of the Gods,67537798,0,67537798,2012.csv,2012,0.0,1.0
1919,12 Strong,67450815,45819713,21631102,2018.csv,2018,0.6793055502739292,0.32069444972607075
1920,The Next Three Days,67448651,21148651,46300000,2010.csv,2010,0.3135518751887269,0.6864481248112732
1921,Star Trek: Nemesis,67336470,43254409,24082061,2002.csv,2002,0.6423622889646576,0.35763771103534236
1922,American Assassin,67234188,36249674,30984514,2017.csv,2017,0.5391553773208356,0.4608446226791644
1923,Boogeyman,67192859,46752382,20440477,2005.csv,2005,0.6957939086949702,0.3042060913050299
1924,War,67179155,4654000,62525155,2019.csv,2019,0.06927744178979328,0.9307225582102068
1925,The Girl Who Played with Fire,67153225,7638241,59514984,2009.csv,2009,0.11374347248400951,0.8862565275159905
1926,"Lust, Caution",67091915,4604982,62486933,2007.csv,2007,0.06863691400074062,0.9313630859992593
1927,When a Stranger Calls,67062123,47860214,19201909,2006.csv,2006,0.7136698311802625,0.2863301688197375
1928,Skyline,66984887,21393620,45591267,2010.csv,2010,0.31937980279044137,0.6806201972095586
1929,The Giver,66980456,45090374,21890082,2014.csv,2014,0.6731870263767687,0.32681297362323125
1930,The Messenger: The Story of Joan of Arc,66976317,14276317,52700000,1999.csv,1999,0.2131547036245663,0.7868452963754338
1931,Madea's Witness Protection,66899242,65653242,1246000,2012.csv,2012,0.9813749758181116,0.018625024181888338
1932,Mulan,66800000,0,66800000,2020.csv,2020,0.0,1.0
1933,Selma,66787908,52076908,14711000,2014.csv,2014,0.779735577284439,0.22026442271556101
1934,A Violent Prosecutor,66736633,0,66736633,2015.csv,2015,0.0,1.0
1935,Thirteen Days,66579890,34592089,31987801,2000.csv,2000,0.5195576171723925,0.48044238282760754
1936,Victoria & Abdul,66558465,22245070,44313395,2017.csv,2017,0.33421849497280326,0.6657815050271968
1937,Take the Lead,66499627,34742066,31757561,2006.csv,2006,0.5224400130845847,0.47755998691541535
1938,Street Kings,66476363,26418667,40057696,2008.csv,2008,0.39741444639502915,0.6025855536049708
1939,Not Another Teen Movie,66468332,38252284,28216048,2001.csv,2001,0.5754963732202577,0.4245036267797423
1940,"Love, Simon",66316289,40826341,25489948,2018.csv,2018,0.615630663531248,0.38436933646875204
1941,Mile 22,66308758,36108758,30200000,2018.csv,2018,0.5445548836851989,0.4554451163148011
1942,One Piece Film: Gold,66207073,423593,65783480,2016.csv,2016,0.00639800221949096,0.9936019977805091
1943,August Rush,66122026,31664162,34457864,2007.csv,2007,0.47887464912221533,0.5211253508777847
1944,Barbershop 2: Back in Business,65991448,65111277,880171,2004.csv,2004,0.9866623475211516,0.013337652478848471
1945,Bad Company,65977295,30160161,35817134,2002.csv,2002,0.45712939580199524,0.5428706041980048
1946,Hitman's Wife's Bodyguard,65927857,38014727,27913130,2021.csv,2021,0.5766109916177011,0.42338900838229887
1947,Flags of Our Fathers,65900249,33602376,32297873,2006.csv,2006,0.50989755744322,0.49010244255678004
1948,Life of the Party,65859911,53059911,12800000,2018.csv,2018,0.8056480823364611,0.1943519176635389
1949,Beijing Love Story,65842375,428318,65414057,2014.csv,2014,0.0065052027664554936,0.9934947972335445
1950,Stuck on You,65784503,33832741,31951762,2003.csv,2003,0.5142965205650334,0.4857034794349666
1951,Escape Room: Tournament of Champions,65774490,25314753,40459737,2021.csv,2021,0.3848719009451841,0.6151280990548159
1952,Sweet November,65754228,25288103,40466125,2001.csv,2001,0.384585201121972,0.6154147988780281
1953,K-19: The Widowmaker,65716126,35168966,30547160,2002.csv,2002,0.5351649304464478,0.4648350695535522
1954,16 Blocks,65664721,36895141,28769580,2006.csv,2006,0.5618715870276827,0.43812841297231736
1955,The Age of Adaline,65663276,42629776,23033500,2015.csv,2015,0.6492179281460158,0.35078207185398425
1956,Matchstick Men,65565672,36906460,28659212,2003.csv,2003,0.5628930334154129,0.43710696658458714
1957,Taxi 3,65497208,497208,65000000,2003.csv,2003,0.007591285417845597,0.9924087145821544
1958,Taking Lives,65470529,32682342,32788187,2004.csv,2004,0.4991916591967662,0.5008083408032338
1959,Eiga Doraemon: Nobita no getsumen tansaki,65406606,0,65406606,2019.csv,2019,0.0,1.0
1960,Moonlight,65336603,27854932,37481671,2016.csv,2016,0.42632966394044086,0.5736703360595592
1961,Underdog,65270477,43760605,21509872,2007.csv,2007,0.6704502098245735,0.32954979017542646
1962,The House That Never Dies,65220000,0,65220000,2014.csv,2014,0.0,1.0
1963,Stand by Me Doraemon 2,65201374,0,65201374,2020.csv,2020,0.0,1.0
1964,Taxi 4,65125001,0,65125001,2007.csv,2007,0.0,1.0
1965,Something Borrowed,65100369,39046489,26053880,2011.csv,2011,0.5997890580312993,0.40021094196870066
1966,Space Chimps,65097693,30105968,34991725,2008.csv,2008,0.4624736547883502,0.5375263452116498
1967,Zathura: A Space Adventure,65079104,29258869,35820235,2005.csv,2005,0.44958930288898874,0.5504106971110112
1968,28 Weeks Later,65048678,28638916,36409762,2007.csv,2007,0.440268993629663,0.559731006370337
1969,K-PAX,65001485,50338485,14663000,2001.csv,2001,0.7744205382384726,0.22557946176152746
1970,The Benchwarmers,64962629,59843754,5118875,2006.csv,2006,0.921202773366823,0.07879722663317705
1971,The Pirates,64858224,415775,64442449,2014.csv,2014,0.006410520892462304,0.9935894791075377
1972,The Bank Job,64822796,30060660,34762136,2008.csv,2008,0.4637359363517735,0.5362640636482264
1973,Lions for Lambs,64811540,15002854,49808686,2007.csv,2007,0.2314843004810563,0.7685156995189437
1974,Hot Tub Time Machine,64735752,50287556,14448196,2010.csv,2010,0.7768127262969,0.22318727370309996
1975,Belle,64696461,4018313,60678148,2021.csv,2021,0.06211024433005694,0.937889755669943
1976,God's Not Dead,64667874,60755732,3912142,2014.csv,2014,0.9395040882277961,0.060495911772203925
1977,The Darkest Hour,64626786,21443494,43183292,2011.csv,2011,0.3318050506178661,0.6681949493821339
1978,Happy Death Day 2U,64600152,28148130,36452022,2019.csv,2019,0.43572854131984085,0.5642714586801592
1979,L Storm,64517456,0,64517456,2018.csv,2018,0.0,1.0
1980,Monster Trucks,64493915,33370166,31123749,2016.csv,2016,0.5174157282900255,0.4825842717099745
1981,Monk Comes Down the Mountain,64455686,0,64455686,2015.csv,2015,0.0,1.0
1982,Miracle,64445708,64378093,67615,2004.csv,2004,0.9989508222952567,0.0010491777047433478
1983,Baby Mama,64444713,60494212,3950501,2008.csv,2008,0.9386993778682823,0.061300622131717775
1984,Kiss of the Dragon,64437847,36845124,27592723,2001.csv,2001,0.5717932195965517,0.4282067804034483
1985,Capernaum,64417003,1661096,62755907,2018.csv,2018,0.025786607923997954,0.974213392076002
1986,Fences,64414761,57682904,6731857,2016.csv,2016,0.8954920130806664,0.10450798691933359
1987,Zhongkui: Snow Girl and the Dark Crystal,64325947,165428,64160519,2015.csv,2015,0.002571714956641058,0.9974282850433589
1988,Isle of Dogs,64241499,32015231,32226268,2018.csv,2018,0.49835747139088393,0.5016425286091161
1989,Suck Me Shakespeer 3,64236772,0,64236772,2017.csv,2017,0.0,1.0
1990,The Rescue,64203587,18797,64184790,2020.csv,2020,0.0002927718041672656,0.9997072281958327
1991,Thunder and the House of Magic,64197205,4091,64193114,2013.csv,2013,6.372551577595941e-05,0.9999362744842241
1992,The Danish Girl,64191523,11114018,53077505,2015.csv,2015,0.1731384064528271,0.8268615935471729
1993,The Boy,64188367,35819556,28368811,2015.csv,2015,0.5580381255064488,0.4419618744935511
1994,The Grandmaster,64076736,6594959,57481777,2013.csv,2013,0.10292282990194757,0.8970771700980524
1995,The Pirate Fairy,63998725,0,63998725,2014.csv,2014,0.0,1.0
1996,The Inbetweeners 2,63852235,0,63852235,2014.csv,2014,0.0,1.0
1997,Hanna,63782078,40259119,23522959,2011.csv,2011,0.6311979832328448,0.3688020167671552
1998,High Crimes,63781810,41543917,22237893,2002.csv,2002,0.651344278251119,0.34865572174888104
1999,Precious,63649529,47566524,16083005,2009.csv,2009,0.7473193399435839,0.25268066005641615
2000,"Hail, Caesar!",63647656,30498085,33149571,2016.csv,2016,0.4791705919225054,0.5208294080774947
2001,Elite Squad 2: The Enemy Within,63618850,100119,63518731,2010.csv,2010,0.0015737316848701288,0.9984262683151298
2002,Footloose 2011 Re-release,63543328,51802742,11740586,2011.csv,2011,0.815234952755386,0.18476504724461396
2003,Conan the Barbarian,63523283,21295021,42228262,2011.csv,2011,0.33523174487061697,0.664768255129383
2004,Begin Again,63464861,16170632,47294229,2014.csv,2014,0.25479661887229216,0.7452033811277078
2005,Colombiana,63458440,36665854,26792586,2011.csv,2011,0.5777931824356224,0.42220681756437756
2006,Side Effects,63414135,32172757,31241378,2013.csv,2013,0.5073436229950941,0.49265637700490594
2007,Madea's Family Reunion,63368939,63318000,50939,2006.csv,2006,0.9991961519191602,0.0008038480808397313
2008,The Host,63365859,26627201,36738658,2013.csv,2013,0.42021368320754554,0.5797863167924544
2009,The Hundred Regiments Offensive,63230000,0,63230000,2015.csv,2015,0.0,1.0
2010,Detective Conan: Crimson Love Letter,63144805,0,63144805,2017.csv,2017,0.0,1.0
2011,Jeepers Creepers 2,63102666,35667218,27435448,2003.csv,2003,0.5652252156826464,0.43477478431735356
2012,The Longest Ride,62944815,37446117,25498698,2015.csv,2015,0.5949039170263667,0.4050960829736333
2013,Unfriended,62882090,32482090,30400000,2015.csv,2015,0.5165555088897331,0.4834444911102668
2014,Piglet's Big Movie,62870546,23103423,39767123,2003.csv,2003,0.36747609922140645,0.6325239007785936
2015,The Mountain Between Us,62832209,30348555,32483654,2017.csv,2017,0.48300951825519933,0.5169904817448007
2016,The Star,62812974,40852824,21960150,2017.csv,2017,0.65038830990553,0.34961169009446996
2017,Inkheart,62803180,17303424,45499756,2008.csv,2008,0.27551827789611927,0.7244817221038807
2018,Little Nicholas,62792067,0,62792067,2009.csv,2009,0.0,1.0
2019,The Nice Guys,62788218,36261763,26526455,2016.csv,2016,0.5775249585837904,0.4224750414162097
2020,The Reaping,62771059,25126214,37644845,2007.csv,2007,0.4002834172353218,0.5997165827646782
2021,Beauty and the Beast 2012 3D Release,62767829,47617067,15150762,2012.csv,2012,0.7586221757008674,0.2413778242991326
2022,Proof of Life,62761005,32598931,30162074,2000.csv,2000,0.5194137824912141,0.4805862175087859
2023,Devil,62695489,33601190,29094299,2010.csv,2010,0.5359427055429777,0.46405729445702226
2024,Runner Runner,62675095,19316646,43358449,2013.csv,2013,0.3082028994132358,0.6917971005867641
2025,After the Sunset,62657868,28331233,34326635,2004.csv,2004,0.45215762847213375,0.5478423715278662
2026,How to Be a Latin Lover,62547032,32149404,30397628,2017.csv,2017,0.5140036700702281,0.4859963299297719
2027,The White Haired Witch of Lunar Kingdom,62515046,0,62515046,2014.csv,2014,0.0,1.0
2028,Andhadhun,62475342,1193046,61282296,2018.csv,2018,0.019096270013215774,0.9809037299867842
2029,Snow Day,62464731,60020107,2444624,2000.csv,2000,0.9608639313599221,0.03913606864007787
2030,Year One,62357900,43337279,19020621,2009.csv,2009,0.6949765627129842,0.30502343728701575
2031,Like Mike,62274780,51432760,10842020,2002.csv,2002,0.8259003082788892,0.17409969172111087
2032,Honey,62228395,30308417,31919978,2003.csv,2003,0.4870512408362774,0.5129487591637226
2033,28 Days,62198945,37170488,25028457,2000.csv,2000,0.5976064063466028,0.40239359365339716
2034,47 Meters Down,62187529,44307191,17880338,2017.csv,2017,0.7124771109654477,0.28752288903455225
2035,Two Brothers,62172050,19176754,42995296,2004.csv,2004,0.30844654470939914,0.6915534552906009
2036,Captain Corelli's Mandolin,62112895,25543895,36569000,2001.csv,2001,0.41124946760250025,0.5887505323974997
2037,White Snake,62098770,34730,62064040,2019.csv,2019,0.0005592703365944285,0.9994407296634056
2038,Brooklyn,62076141,38322743,23753398,2015.csv,2015,0.6173506017392415,0.3826493982607585
2039,Snakes on a Plane,62022014,34020814,28001200,2006.csv,2006,0.5485280436072263,0.4514719563927737
2040,Friday Night Lights,61950770,61255921,694849,2004.csv,2004,0.9887838520812574,0.011216147918742576
2041,The Imaginarium of Doctor Parnassus,61808775,7689607,54119168,2009.csv,2009,0.12440963277463435,0.8755903672253657
2042,"Dragon Ball Z: Resurrection ""F""",61768190,8008363,53759827,2015.csv,2015,0.1296518968744268,0.8703481031255732
2043,Valiant,61746888,19478106,42268782,2005.csv,2005,0.3154508126790131,0.6845491873209869
2044,The 13th Warrior,61698899,32698899,29000000,1999.csv,1999,0.5299754052337303,0.4700245947662697
2045,"Everything, Everything",61621140,34121140,27500000,2017.csv,2017,0.5537245821807256,0.4462754178192744
2046,Woman in Gold,61619773,33307793,28311980,2015.csv,2015,0.540537418078447,0.459462581921553
2047,Ninja Assassin,61601280,38122883,23478397,2009.csv,2009,0.6188651112444417,0.38113488875555834
2048,The Face Reader,61559184,515876,61043308,2013.csv,2013,0.008380163063889865,0.9916198369361101
2049,Krampus,61548707,42725475,18823232,2015.csv,2015,0.694173396688902,0.305826603311098
2050,From Up on Poppy Hill,61459425,1002895,60456530,2011.csv,2011,0.0163180016734618,0.9836819983265382
2051,Bombshell,61404394,31762808,29641586,2019.csv,2019,0.5172725587032094,0.48272744129679057
2052,A History of Violence,61385065,31504633,29880432,2005.csv,2005,0.5132296104923894,0.4867703895076107
2053,Ashfall,61354854,372562,60982292,2019.csv,2019,0.006072249801132279,0.9939277501988677
2054,Astérix and Obélix: God Save Britannia,61319383,0,61319383,2012.csv,2012,0.0,1.0
2055,In Good Company,61315215,45806659,15508556,2004.csv,2004,0.7470683907738072,0.2529316092261929
2056,The Legend of Hercules,61279452,18848538,42430914,2013.csv,2013,0.30758333152195944,0.6924166684780406
2057,The Walk,61181942,10137502,51044440,2014.csv,2014,0.16569434817874856,0.8343056518212515
2058,Doraemon: Great Adventure in the Antarctic Kachi Kochi,61153455,0,61153455,2017.csv,2017,0.0,1.0
2059,Crossroads,61141030,37191304,23949726,2002.csv,2002,0.6082871682076668,0.39171283179233324
2060,My Super Ex-Girlfriend,61108981,22530295,38578686,2006.csv,2006,0.36869040575230666,0.6313095942476933
2061,Ma,61105672,45896028,15209644,2019.csv,2019,0.7510927627144007,0.24890723728559927
2062,Marie Antoinette,60917189,15962471,44954718,2006.csv,2006,0.2620355807947737,0.7379644192052263
2063,Snatched,60845711,45852178,14993533,2017.csv,2017,0.7535811028652455,0.24641889713475448
2064,Kick-Ass 2,60795985,28795985,32000000,2013.csv,2013,0.4736494523445915,0.5263505476554085
2065,Zoolander,60780981,45172250,15608731,2001.csv,2001,0.7431971195068404,0.2568028804931595
2066,127 Hours,60738797,18335230,42403567,2010.csv,2010,0.301870153931432,0.698129846068568
2067,Taxi 2,60726164,626164,60100000,2000.csv,2000,0.010311272090231156,0.9896887279097688
2068,500 Days of Summer,60722734,32391374,28331360,2009.csv,2009,0.5334307575808428,0.4665692424191572
2069,The Wild Thornberrys,60694737,40108697,20586040,2002.csv,2002,0.660826605114048,0.339173394885952
2070,Ron's Gone Wrong,60692022,23009270,37682752,2021.csv,2021,0.37911523198222,0.62088476801778
2071,Why Did I Get Married Too?,60673972,60095852,578120,2010.csv,2010,0.9904716968257822,0.009528303174217769
2072,Love You Forever,60670799,0,60670799,2020.csv,2020,0.0,1.0
2073,What a Beautiful Day,60661950,0,60661950,2011.csv,2011,0.0,1.0
2074,The Founding of an Army,60600361,0,60600361,2017.csv,2017,0.0,1.0
2075,Evangelion: 3.0 You Can (Not) Redo,60488344,174945,60313399,2012.csv,2012,0.002892210109107963,0.997107789890892
2076,21 Grams,60427839,16290476,44137363,2003.csv,2003,0.2695856126842464,0.7304143873157536
2077,Limit of Love: Umizaru,60369589,0,60369589,2006.csv,2006,0.0,1.0
2078,The Ghost Writer,60331447,15541549,44789898,2010.csv,2010,0.2576027888076346,0.7423972111923653
2079,My Little Pony: The Movie,60330833,21885107,38445726,2017.csv,2017,0.3627516132588456,0.6372483867411544
2080,Secretariat,60321861,59713955,607906,2010.csv,2010,0.9899222936772458,0.0100777063227542
2081,The Insider,60289912,29089912,31200000,1999.csv,1999,0.48250048863896167,0.5174995113610383
2082,The Perfect Guy,60273173,57027435,3245738,2015.csv,2015,0.9461495415215655,0.05385045847843451
2083,3 Idiots,60262836,6532874,53729962,2009.csv,2009,0.10840634848316796,0.891593651516832
2084,The International,60253843,25450527,34803316,2009.csv,2009,0.42238844416944493,0.5776115558305551
2085,A Haunted House,60159584,40041683,20117901,2013.csv,2013,0.6655910885288037,0.33440891147119634
2086,The Crimson Rivers,60094966,594966,59500000,2001.csv,2001,0.009900429929521884,0.9900995700704781
2087,Beautiful Creatures,60052138,19452138,40600000,2013.csv,2013,0.323920823601651,0.676079176398349
2088,Morning Glory,60040976,31011732,29029244,2010.csv,2010,0.5165094584738262,0.4834905415261737
2089,My Best Summer,60011073,0,60011073,2019.csv,2019,0.0,1.0
2090,Forever Young,59981902,149761,59832141,2015.csv,2015,0.0024967697756566637,0.9975032302243433
2091,Son of the Mask,59981548,17018422,42963126,2005.csv,2005,0.28372762236813226,0.7162723776318677
2092,Keeping the Faith,59945183,37047880,22897303,2000.csv,2000,0.6180293085434404,0.3819706914565596
2093,Adrift,59945012,31445012,28500000,2018.csv,2018,0.5245642790095696,0.47543572099043035
2094,Next Friday,59827328,57328603,2498725,2000.csv,2000,0.9582343874692181,0.04176561253078192
2095,Good Luck Chuck,59768495,35017297,24751198,2007.csv,2007,0.5858821942898177,0.41411780571018225
2096,Quartet,59520298,18390117,41130181,2012.csv,2012,0.3089721929819639,0.6910278070180361
2097,The Flintstones in Viva Rock Vegas,59468275,35268275,24200000,2000.csv,2000,0.5930603334298834,0.4069396665701166
2098,Rock of Ages,59418613,38518613,20900000,2012.csv,2012,0.6482583664482373,0.35174163355176263
2099,Miss Granny,59396311,234573,59161738,2015.csv,2015,0.003949285671967069,0.9960507143280329
2100,One Day,59389433,13843771,45545662,2011.csv,2011,0.23310158559688557,0.7668984144031145
2101,Molly's Game,59284015,28780744,30503271,2017.csv,2017,0.48547224745152634,0.5145277525484736
2102,Jeepers Creepers,59217789,37904175,21313614,2001.csv,2001,0.6400808885316539,0.3599191114683461
2103,The Devotion of Suspect X,59035664,686435,58349229,2017.csv,2017,0.011627463019641822,0.9883725369803582
2104,The Gift,58978653,43787265,15191388,2015.csv,2015,0.742425653566554,0.257574346433446
2105,Miss Granny,58940254,0,58940254,2014.csv,2014,0.0,1.0
2106,The Story of Us,58900031,27100031,31800000,1999.csv,1999,0.46010215172891844,0.5398978482710816
2107,Under the Tuscan Sun,58878723,43610723,15268000,2003.csv,2003,0.7406873107624974,0.25931268923750267
2108,A Walk Among the Tombstones,58834384,26307600,32526784,2014.csv,2014,0.44714668891578774,0.5528533110842122
2109,Shock Wave,58815633,0,58815633,2017.csv,2017,0.0,1.0
2110,Agent Cody Banks,58795814,47938330,10857484,2003.csv,2003,0.8153357652298172,0.1846642347701828
2111,Invincible,58480828,57806952,673876,2006.csv,2006,0.98847697573639,0.011523024263609948
2112,Monster,58469210,34469210,24000000,2003.csv,2003,0.5895275479179555,0.4104724520820445
2113,The Tree of Life,58409247,13303319,45105928,2011.csv,2011,0.22776049484082547,0.7722395051591745
2114,Are We Done Yet?,58388068,49662533,8725535,2007.csv,2007,0.8505596211883565,0.14944037881164352
2115,Cloudy Mountain,58340541,0,58340541,2021.csv,2021,0.0,1.0
2116,Beginning of the Great Revival,58309289,151000,58158289,2011.csv,2011,0.0025896388481087464,0.9974103611518913
2117,Little Nicky,58292295,39464775,18827520,2000.csv,2000,0.6770152899281114,0.32298471007188856
2118,Must Love Dogs,58231520,43894863,14336657,2005.csv,2005,0.7537990249953976,0.2462009750046023
2119,Huo guo ying xiong,58106427,779818,57326609,2016.csv,2016,0.013420511985705126,0.9865794880142948
2120,L.O.R.D: Legend of Ravaging Dynasties,58089494,350456,57739038,2016.csv,2016,0.0060330358532646195,0.9939669641467354
2121,Doom,58072119,28212337,29859782,2005.csv,2005,0.4858155253470258,0.5141844746529741
2122,The Eye,58010320,31418697,26591623,2008.csv,2008,0.5416053040217672,0.45839469597823285
2123,Bowling for Columbine,58008423,21576018,36432405,2002.csv,2002,0.3719462947648137,0.6280537052351862
2124,Sky Captain and the World of Tomorrow,57947036,37762677,20184359,2004.csv,2004,0.6516757302306195,0.3483242697693804
2125,Aliens in the Attic,57881056,25200412,32680644,2009.csv,2009,0.4353827269495567,0.5646172730504433
2126,Snitch,57824674,42930462,14894212,2013.csv,2013,0.7424246265530179,0.25757537344698217
2127,Dolphin Tale 2,57824533,42024533,15800000,2014.csv,2014,0.7267595745217692,0.27324042547823085
2128,Nine Lives,57814445,19700032,38114413,2016.csv,2016,0.3407458464748732,0.6592541535251268
2129,Heartbreakers,57756408,40336607,17419801,2001.csv,2001,0.6983918909915589,0.3016081090084411
2130,That's My Boy,57719093,36931089,20788004,2012.csv,2012,0.6398418110970663,0.3601581889029337
2131,Avatar 2021 Re-release,57700000,0,57700000,2021.csv,2021,0.0,1.0
2132,Cellular,57678321,32003620,25674701,2004.csv,2004,0.5548639323256306,0.44513606767436936
2133,The Motorcycle Diaries,57663224,16781387,40881837,2004.csv,2004,0.2910240849523086,0.7089759150476914
2134,Goldbuster,57628292,186135,57442157,2017.csv,2017,0.0032299239408310073,0.996770076059169
2135,Ready or Not,57615777,28714231,28901546,2019.csv,2019,0.4983744469852416,0.5016255530147584
2136,Drumline,57588485,56399184,1189301,2002.csv,2002,0.9793482846440569,0.02065171535594312
2137,Derailed,57479076,36024076,21455000,2005.csv,2005,0.6267337352465443,0.3732662647534557
2138,The Mist,57470220,25594957,31875263,2007.csv,2007,0.4453603448881873,0.5546396551118127
2139,Seven Dwarves,57410311,0,57410311,2004.csv,2004,0.0,1.0
2140,The Physician,57284237,0,57284237,2013.csv,2013,0.0,1.0
2141,Smokin' Aces,57232879,35787686,21445193,2007.csv,2007,0.6252994192376728,0.3747005807623272
2142,Walking Tall,57223890,46437717,10786173,2004.csv,2004,0.8115092664969124,0.18849073350308762
2143,Prom Night,57197876,43869350,13328526,2008.csv,2008,0.766975158308326,0.233024841691674
2144,She's the Man,57194667,33741133,23453534,2006.csv,2006,0.5899349497043143,0.4100650502956858
2145,Jade Dynasty,57149764,0,57149764,2019.csv,2019,0.0,1.0
2146,Killer Elite,57084522,25124966,31959556,2011.csv,2011,0.44013622466699465,0.5598637753330054
2147,Gekijouban Tenpesuto 3D,57082491,0,57082491,2011.csv,2011,0.0,1.0
2148,The 15:17 to Paris,57076286,36276286,20800000,2018.csv,2018,0.6355754472181319,0.36442455278186814
2149,The Descent,57051053,26024456,31026597,2005.csv,2005,0.45616083545381714,0.5438391645461829
2150,All the Money in the World,56996304,25113707,31882597,2017.csv,2017,0.44061992160053043,0.5593800783994696
2151,Elektra,56995646,24409722,32585924,2005.csv,2005,0.4282734509229003,0.5717265490770996
2152,Lake Placid,56870414,31770414,25100000,1999.csv,1999,0.5586457309770947,0.4413542690229053
2153,Zoolander 2,56722693,28848693,27874000,2016.csv,2016,0.5085917377018754,0.4914082622981247
2154,Murder by Numbers,56714147,31945749,24768398,2002.csv,2002,0.5632765489711059,0.4367234510288941
2155,Into the Wild,56674477,18354356,38320121,2007.csv,2007,0.32385576315066833,0.6761442368493317
2156,You Are My Sunshine,56640000,0,56640000,2015.csv,2015,0.0,1.0
2157,Das perfekte Geheimnis,56573047,0,56573047,2019.csv,2019,0.0,1.0
2158,Cradle 2 the Grave,56489558,34712347,21777211,2003.csv,2003,0.6144913897184325,0.3855086102815674
2159,The Big Sick,56411585,42873127,13538458,2017.csv,2017,0.7600057151381228,0.2399942848618772
2160,Vicky the Viking,56390258,0,56390258,2009.csv,2009,0.0,1.0
2161,15 Minutes,56359980,24403552,31956428,2001.csv,2001,0.43299433392275866,0.5670056660772413
2162,Lucky Number Slevin,56308881,22495466,33813415,2006.csv,2006,0.3995012083440266,0.6004987916559734
2163,Frida,56298474,25885000,30413474,2002.csv,2002,0.4597815564237141,0.5402184435762859
2164,A or B,56239049,0,56239049,2018.csv,2018,0.0,1.0
2165,Eastern Promises,56106607,17266000,38840607,2007.csv,2007,0.30773559342128814,0.6922644065787118
2166,Nezha Reborn,56088478,0,56088478,2021.csv,2021,0.0,1.0
2167,Kicking & Screaming,56070433,52842724,3227709,2005.csv,2005,0.9424347409623178,0.05756525903768212
2168,The Big Shot,56040681,0,56040681,2019.csv,2019,0.0,1.0
2169,Remember Me,56032889,19068240,36964649,2010.csv,2010,0.3403044237108674,0.6596955762891327
2170,The Odd Life of Timothy Green,56012642,51854875,4157767,2012.csv,2012,0.9257709179295631,0.07422908207043688
2171,"Definitely, Maybe",55990299,32241649,23748650,2008.csv,2008,0.5758434867440161,0.42415651325598386
2172,Gongjo,55972241,475618,55496623,2017.csv,2017,0.008497390697649572,0.9915026093023505
2173,Under the Sea 3D,55902624,36262926,19639698,2009.csv,2009,0.6486802122204496,0.35131978777955036
2174,Tyler Perry's Why Did I Get Married?,55862886,55204525,658361,2007.csv,2007,0.9882146976796007,0.011785302320399272
2175,Firestorm,55754766,0,55754766,2013.csv,2013,0.0,1.0
2176,Dallas Buyers Club,55736588,27298285,28438303,2013.csv,2013,0.4897731630073947,0.5102268369926053
2177,Dragonball Evolution,55720772,9362785,46357987,2009.csv,2009,0.16803042499124024,0.8319695750087598
2178,Pay It Forward,55707411,33519628,22187783,2000.csv,2000,0.6017085949300355,0.3982914050699646
2179,Nobody,55705035,27568035,28137000,2021.csv,2021,0.4948930558970118,0.5051069441029882
2180,All Eyez on Me,55668698,44922302,10746396,2017.csv,2017,0.806958014358446,0.1930419856415539
2181,The Irony of Fate 2,55639741,0,55639741,2007.csv,2007,0.0,1.0
2182,Cop Out,55611001,44875481,10735520,2010.csv,2010,0.8069533040773713,0.19304669592262869
2183,The Lizzie McGuire Movie,55534455,42734455,12800000,2003.csv,2003,0.7695124585268731,0.23048754147312692
2184,Out of Time,55495563,41088845,14406718,2003.csv,2003,0.7403987414273101,0.25960125857268984
2185,Spanglish,55470154,42726869,12743285,2004.csv,2004,0.7702677191053048,0.2297322808946952
2186,Lawless,55404159,37400127,18004032,2012.csv,2012,0.6750418682467502,0.3249581317532498
2187,Silent Hill: Revelation,55362705,17529157,37833548,2011.csv,2011,0.31662392579986837,0.6833760742001317
2188,Rugrats Go Wild,55250496,39402572,15847924,2003.csv,2003,0.7131623216558997,0.2868376783441003
2189,Extremely Loud & Incredibly Close,55247881,31847881,23400000,2011.csv,2011,0.5764543440136646,0.4235456559863355
2190,The Ant Bully,55181129,28142535,27038594,2006.csv,2006,0.5100028852254908,0.48999711477450925
2191,The Mothman Prophecies,55157539,35746370,19411169,2002.csv,2002,0.6480776816384066,0.3519223183615933
2192,End of Watch,55078146,41003371,14074775,2012.csv,2012,0.744458083247755,0.2555419167522451
2193,Hellboy,55064690,21903748,33160942,2019.csv,2019,0.39778209956325916,0.6022179004367408
2194,We Own the Night,55033767,28563179,26470588,2007.csv,2007,0.5190118822867422,0.4809881177132578
2195,Barbershop: The Next Cut,55030051,54030051,1000000,2016.csv,2016,0.9818281106081476,0.018171889391852464
2196,Veda - Atatürk,55024621,0,55024621,2010.csv,2010,0.0,1.0
2197,The Messengers,55010659,35374833,19635826,2007.csv,2007,0.6430541579223764,0.35694584207762353
2198,Downsizing,55003890,24449754,30554136,2017.csv,2017,0.44450954287051336,0.5554904571294866
2199,Analyze That,55003135,32130627,22872508,2002.csv,2002,0.5841599210663174,0.4158400789336826
2200,Wolf Children,54984346,0,54984346,2012.csv,2012,0.0,1.0
2201,Suspect X,54846110,0,54846110,2008.csv,2008,0.0,1.0
2202,St. Vincent,54837234,44137712,10699522,2014.csv,2014,0.8048858190039272,0.19511418099607286
2203,The Three Stooges,54819301,44338224,10481077,2012.csv,2012,0.8088068105793614,0.19119318942063854
2204,The Crazies,54806823,39123589,15683234,2010.csv,2010,0.7138452268981181,0.28615477310188187
2205,Driven,54744738,32720065,22024673,2001.csv,2001,0.5976842011738187,0.40231579882618124
2206,The Punisher,54700105,33810189,20889916,2004.csv,2004,0.6181009890200394,0.38189901097996065
2207,Open Water,54683487,30610863,24072624,2004.csv,2004,0.5597825720221536,0.4402174279778464
2208,Go Brother!,54663060,0,54663060,2018.csv,2018,0.0,1.0
2209,"Good Night, and Good Luck.",54641191,31558003,23083188,2005.csv,2005,0.5775496914040545,0.4224503085959455
2210,The Hot Chick,54639553,35081594,19557959,2002.csv,2002,0.6420549231067099,0.3579450768932901
2211,Early Man,54622814,8267544,46355270,2018.csv,2018,0.15135697695838227,0.8486430230416178
2212,Milk,54589558,31841299,22748259,2008.csv,2008,0.5832855250449179,0.41671447495508207
2213,The Age of Shadows,54491162,541719,53949443,2016.csv,2016,0.009941410315309481,0.9900585896846905
2214,No Escape,54418872,27288872,27130000,2015.csv,2015,0.5014597141962075,0.4985402858037925
2215,No Good Deed,54323210,52543632,1779578,2014.csv,2014,0.9672409270365282,0.03275907296347178
2216,Upcoming,54300000,0,54300000,2021.csv,2021,0.0,1.0
2217,Varsity Blues,54294169,52894169,1400000,1999.csv,1999,0.9742145422651187,0.025785457734881254
2218,Mickey Blue Eyes,54264342,33864342,20400000,1999.csv,1999,0.6240625197298071,0.3759374802701929
2219,Domestic Disturbance,54249294,45246095,9003199,2001.csv,2001,0.8340402549754841,0.1659597450245159
2220,The Five-Year Engagement,54169363,28835528,25333835,2012.csv,2012,0.5323217110749484,0.4676782889250516
2221,Madea's Big Happy Family,54161287,53345287,816000,2011.csv,2011,0.9849338882955274,0.015066111704472605
2222,Nine,54004950,19676965,34327985,2009.csv,2009,0.36435484154693226,0.6356451584530677
2223,A Ghost of a Chance,53982636,0,53982636,2011.csv,2011,0.0,1.0
2224,"I, Tonya",53939297,30014539,23924758,2017.csv,2017,0.5564503185868366,0.4435496814131634
2225,Peppermint,53918723,35418723,18500000,2018.csv,2018,0.6568909838610235,0.34310901613897643
2226,Long Shot,53873809,30316271,23557538,2019.csv,2019,0.5627274470234692,0.4372725529765308
2227,1987: When the Day Comes,53834292,0,53834292,2017.csv,2017,0.0,1.0
2228,Stranger Than Fiction,53653224,40660952,12992272,2006.csv,2006,0.7578473196689913,0.24215268033100862
2229,Overheard 3,53493428,0,53493428,2014.csv,2014,0.0,1.0
2230,10 Things I Hate About You,53478166,38178166,15300000,1999.csv,1999,0.7139019314910687,0.28609806850893127
2231,The Cat Returns,53452652,0,53452652,2002.csv,2002,0.0,1.0
2232,Bounce,53425292,36805288,16620004,2000.csv,2000,0.6889113118932508,0.31108868810674917
2233,Supercondriaque,53425036,0,53425036,2014.csv,2014,0.0,1.0
2234,A Madea Christmas,53396635,52543354,853281,2013.csv,2013,0.9840199480735069,0.01598005192649312
2235,Sinister 2,53329150,27740955,25588195,2015.csv,2015,0.5201837081596088,0.4798162918403912
2236,Æon Flux,53321673,25874337,27447336,2005.csv,2005,0.48524990954428604,0.514750090455714
2237,Little White Lies,53319615,206088,53113527,2010.csv,2010,0.003865144187556493,0.9961348558124435
2238,A Chinese Odyssey: Part Three,53306108,0,53306108,2016.csv,2016,0.0,1.0
2239,Radio,53293628,52333738,959890,2003.csv,2003,0.9819886535028165,0.01801134649718349
2240,3 Days to Kill,53260230,30697999,22562231,2014.csv,2014,0.5763775147046868,0.4236224852953132
2241,Pitch Black,53187659,39240659,13947000,2000.csv,2000,0.7377775171492319,0.26222248285076805
2242,Temptation: Confessions of a Marriage Counselor,53143144,51975354,1167790,2013.csv,2013,0.9780255756038823,0.021974424396117777
2243,Delivery Man,53120346,30664106,22456240,2013.csv,2013,0.5772572716299702,0.4227427283700298
2244,Big Fat Liar,52970014,48360547,4609467,2002.csv,2002,0.91297969073597,0.08702030926403002
2245,The Outlaws,52946454,0,52946454,2017.csv,2017,0.0,1.0
2246,Man in Love,52946097,0,52946097,2021.csv,2021,0.0,1.0
2247,Untraceable,52933513,28687835,24245678,2008.csv,2008,0.5419597788644785,0.45804022113552145
2248,Detective Conan: Sunflowers of Inferno,52920296,0,52920296,2015.csv,2015,0.0,1.0
2249,Pooh's Heffalump Movie,52858433,18098433,34760000,2005.csv,2005,0.34239442928624086,0.6576055707137591
2250,From Paris with Love,52830951,24077427,28753524,2010.csv,2010,0.4557447205521627,0.5442552794478374
2251,Prem Ratan Dhan Payo,52715771,4364639,48351132,2015.csv,2015,0.08279569694617575,0.9172043030538243
2252,Break Through the Darkness,52700000,0,52700000,2021.csv,2021,0.0,1.0
2253,Rurouni Kenshin Part II: Kyoto Inferno,52696176,0,52696176,2014.csv,2014,0.0,1.0
2254,Wild,52501541,37880356,14621185,2014.csv,2014,0.7215094124570554,0.2784905875429447
2255,Tunnel,52444295,568876,51875419,2016.csv,2016,0.010847242774452398,0.9891527572255476
2256,The Boy Next Door,52425855,35423380,17002475,2015.csv,2015,0.6756853083273511,0.3243146916726489
2257,The Night Before,52395996,43047372,9348624,2015.csv,2015,0.8215775113808315,0.17842248861916854
2258,Arthur et la vengeance de Maltazard,52377611,0,52377611,2009.csv,2009,0.0,1.0
2259,Dragonfly,52323400,30323400,22000000,2002.csv,2002,0.5795380269630797,0.4204619730369204
2260,Greenland,52300000,0,52300000,2020.csv,2020,0.0,1.0
2261,Hollywood Adventures,52265070,0,52265070,2015.csv,2015,0.0,1.0
2262,One Hour Photo,52223306,31597131,20626175,2002.csv,2002,0.6050388881929459,0.3949611118070541
2263,Tolo Tolo,52186426,0,52186426,2020.csv,2020,0.0,1.0
2264,Patriots Day,52185751,31886361,20299390,2016.csv,2016,0.6110166163940038,0.3889833836059962
2265,My Beloved Bodyguard,52165873,0,52165873,2016.csv,2016,0.0,1.0
2266,Elizabethtown,52164016,26850426,25313590,2005.csv,2005,0.51473080600236,0.48526919399764007
2267,Take Off,52141043,0,52141043,2009.csv,2009,0.0,1.0
2268,The Finest Hours,52099090,27569558,24529532,2016.csv,2016,0.5291754232175648,0.47082457678243517
2269,Teen Titans GO! To the Movies,52090236,29790236,22300000,2018.csv,2018,0.5718967370391641,0.4281032629608359
2270,Detective Dee: The Mystery of the Phantom Flame,51899269,459836,51439433,2010.csv,2010,0.008860163329082727,0.9911398366709173
2271,Conference of Animals,51883642,0,51883642,2010.csv,2010,0.0,1.0
2272,Hanging Up,51880044,36050230,15829814,2000.csv,2000,0.6948766273212875,0.3051233726787125
2273,Blue Crush,51843679,40390647,11453032,2002.csv,2002,0.7790852767219703,0.22091472327802972
2274,"Yo-kai Watch Movie: It's the Secret of Birth, Meow!",51838845,257343,51581502,2015.csv,2015,0.004964288845555876,0.9950357111544441
2275,Enough,51806184,40007742,11798442,2002.csv,2002,0.7722580377663022,0.2277419622336978
2276,The Texas Chainsaw Massacre: The Beginning,51764406,39517763,12246643,2006.csv,2006,0.7634157532880799,0.23658424671192016
2277,Slender Man,51738549,30569484,21169065,2018.csv,2018,0.5908454061979975,0.4091545938020025
2278,I Can Do Bad All by Myself,51733921,51733921,0,2009.csv,2009,1.0,0.0
2279,Doubt,51699984,33446470,18253514,2008.csv,2008,0.6469338559176343,0.3530661440823657
2280,Schemes in Antiques,51637422,36501,51600921,2021.csv,2021,0.0007068710750122265,0.9992931289249878
2281,Master,51636415,597251,51039164,2016.csv,2016,0.011566469128424194,0.9884335308715758
2282,College Road Trip,51549674,45610425,5939249,2008.csv,2008,0.8847859057265813,0.11521409427341868
2283,Daybreakers,51416464,30101577,21314887,2010.csv,2010,0.5854462687282423,0.4145537312717576
2284,Breaking In,51411620,46840590,4571030,2018.csv,2018,0.9110895552406246,0.08891044475937541
2285,Cry Me a Sad River,51400614,0,51400614,2018.csv,2018,0.0,1.0
2286,I Spy,51386477,33561137,17825340,2002.csv,2002,0.6531122380699498,0.3468877619300502
2287,Hot Pursuit,51380201,34580201,16800000,2015.csv,2015,0.6730258022929883,0.3269741977070117
2288,Once Upon a Deadpool 2018 Re-release,51349833,6100309,45249524,2018.csv,2018,0.1187990036890675,0.8812009963109325
2289,Meet Dave,51339567,11803254,39536313,2008.csv,2008,0.22990560087894782,0.7700943991210522
2290,Simmba,51329025,5102129,46226896,2018.csv,2018,0.09940046591572702,0.900599534084273
2291,Ambulance,51309115,22309115,29000000,2022.csv,2022,0.43479828096820616,0.5652017190317938
2292,Defiance,51262751,28644813,22617938,2008.csv,2008,0.5587841549900433,0.44121584500995664
2293,The 100 Year-Old Man Who Climbed Out the Window and Disappeared,51167572,944193,50223379,2013.csv,2013,0.018452956884489263,0.9815470431155108
2294,Hollywood Homicide,51142659,30940691,20201968,2003.csv,2003,0.6049879221180111,0.3950120778819889
2295,Doomsday: The Sinking of Japan,51127401,0,51127401,2006.csv,2006,0.0,1.0
2296,Sunny,51116421,0,51116421,2011.csv,2011,0.0,1.0
2297,Magic in the Moonlight,51029361,10539326,40490035,2014.csv,2014,0.20653454782629946,0.7934654521737006
2298,Talk to Her 2002 Re-release,51001550,9285469,41716081,2002.csv,2002,0.1820624863361996,0.8179375136638004
2299,Red Dawn,50950296,44806783,6143513,2012.csv,2012,0.8794214463444923,0.12057855365550771
2300,Doraemon the Movie: Nobita and the Birth of Japan,50939840,0,50939840,2016.csv,2016,0.0,1.0
2301,Just Friends,50912434,32619671,18292763,2005.csv,2005,0.6407014640077903,0.3592985359922097
2302,Unleashed,50871113,24537621,26333492,2005.csv,2005,0.4823488135594753,0.5176511864405247
2303,Vanguard,50866901,793525,50073376,2020.csv,2020,0.015600026429760288,0.9843999735702397
2304,Just Mercy,50851872,36001502,14850370,2019.csv,2019,0.7079680763768146,0.2920319236231854
2305,Team America: World Police,50826898,32786074,18040824,2004.csv,2004,0.64505360921298,0.3549463907870199
2306,Coco Before Chanel,50812934,6113834,44699100,2009.csv,2009,0.12032042865306695,0.8796795713469331
2307,The Skulls,50802120,35046120,15756000,2000.csv,2000,0.6898554627247839,0.31014453727521607
2308,What a Girl Wants,50732139,36105433,14626706,2003.csv,2003,0.7116875754046168,0.2883124245953832
2309,Pokémon: Arceus and the Jewel of Life,50673078,0,50673078,2009.csv,2009,0.0,1.0
2310,Sea Monsters: A Prehistoric Adventure,50652463,23746066,26906397,2007.csv,2007,0.46880377761689496,0.531196222383105
2311,Diary of a Mad Black Woman,50652203,50633099,19104,2005.csv,2005,0.9996228397015624,0.0003771602984375625
2312,Fever Pitch,50605163,42071069,8534094,2005.csv,2005,0.8313592231685925,0.1686407768314075
2313,The Jungle Book 2 2003 Re-release,50600160,0,50600160,2003.csv,2003,0.0,1.0
2314,War of the Arrows,50587661,251200,50336461,2011.csv,2011,0.004965637766885486,0.9950343622331145
2315,You Got Served,50576805,40363810,10212995,2004.csv,2004,0.7980695894096118,0.20193041059038822
2316,Kingdom,50574061,0,50574061,2019.csv,2019,0.0,1.0
2317,The Himalayas,50544493,696717,49847776,2015.csv,2015,0.013784231647154914,0.9862157683528451
2318,Alpha and Omega,50507267,25107267,25400000,2010.csv,2010,0.49710207048027366,0.5028979295197263
2319,Marry Me,50485729,22438180,28047549,2022.csv,2022,0.44444599383718913,0.5555540061628109
2320,Dragon Ball Z: Battle of Gods,50461371,2553002,47908369,2013.csv,2013,0.05059319533747904,0.9494068046625209
2321,Kokowääh,50447784,0,50447784,2011.csv,2011,0.0,1.0
2322,About Last Night,50445860,48637684,1808176,2014.csv,2014,0.9641561071612219,0.03584389283877805
2323,Breakthrough,50444358,40713082,9731276,2019.csv,2019,0.8070889117074302,0.1929110882925698
2324,Red Tails,50365498,49876377,489121,2012.csv,2012,0.9902885701636466,0.009711429836353449
2325,"Monsters, Inc. 2012 3D Release",50207820,34043006,16164814,2012.csv,2012,0.6780419066193274,0.32195809338067255
2326,HOUBA! On the Trail of the Marsupilami,50146474,0,50146474,2012.csv,2012,0.0,1.0
2327,The Closet,50104745,6678894,43425851,2001.csv,2001,0.13329863269436856,0.8667013673056314
2328,National Security,50097949,36381186,13716763,2003.csv,2003,0.7262011065562783,0.2737988934437216
2329,The Replacements,50054511,44737059,5317452,2000.csv,2000,0.8937667775837427,0.10623322241625735
2330,Uncut Gems,50023780,50023780,0,2019.csv,2019,1.0,0.0
2331,The Women,50007546,26902075,23105471,2008.csv,2008,0.5379603110298594,0.46203968897014064
2332,Dearest 2014 Re-release,50000583,0,50000583,2014.csv,2014,0.0,1.0
2333,Family is Family,49954866,0,49954866,2018.csv,2018,0.0,1.0
2334,Drillbit Taylor,49944325,32862104,17082221,2008.csv,2008,0.6579747348672748,0.3420252651327253
2335,21 Bridges,49939757,28539757,21400000,2019.csv,2019,0.5714836978481894,0.42851630215181064
2336,Winnie the Pooh,49871429,26692846,23178583,2011.csv,2011,0.535233229430823,0.464766770569177
2337,The Wailing,49851770,786633,49065137,2016.csv,2016,0.015779439727014708,0.9842205602729853
2338,The Switch,49830607,27779426,22051181,2010.csv,2010,0.5574771746208108,0.44252282537918913
2339,Space Battleship Yamato,49827298,0,49827298,2010.csv,2010,0.0,1.0
2340,Notes on a Scandal,49814392,17510118,32304274,2006.csv,2006,0.35150721100841703,0.648492788991583
2341,An Inconvenient Truth,49782012,24146161,25635851,2006.csv,2006,0.4850378686984367,0.5149621313015633
2342,She's Out of My League,49779728,32010860,17768868,2010.csv,2010,0.6430501187149917,0.3569498812850082
2343,This Christmas,49778552,49121934,656618,2007.csv,2007,0.9868092185566185,0.01319078144338148
2344,Luca,49750471,0,49750471,2021.csv,2021,0.0,1.0
2345,Raising Helen,49718611,37486512,12232099,2004.csv,2004,0.7539734366271817,0.24602656337281828
2346,The Boy and the Beast,49714378,490643,49223735,2015.csv,2015,0.009869237426645467,0.9901307625733545
2347,Two Is a Family,49619118,0,49619118,2016.csv,2016,0.0,1.0
2348,Song of Youth,49615508,0,49615508,2019.csv,2019,0.0,1.0
2349,Surprise,49567466,0,49567466,2015.csv,2015,0.0,1.0
2350,Death Wish,49562710,34017028,15545682,2018.csv,2018,0.6863431801852643,0.3136568198147357
2351,CJ7,49529913,207378,49322535,2008.csv,2008,0.004186924374367466,0.9958130756256325
2352,The Grudge,49511319,21221803,28289516,2019.csv,2019,0.4286252806151256,0.5713747193848744
2353,Tad: The Lost Explorer,49490859,0,49490859,2012.csv,2012,0.0,1.0
2354,The Black Dahlia,49332692,22545080,26787612,2006.csv,2006,0.45700080587534125,0.5429991941246588
2355,Capote,49327405,28750530,20576875,2005.csv,2005,0.5828510540945748,0.4171489459054252
2356,May 18,49282156,0,49282156,2007.csv,2007,0.0,1.0
2357,One Piece: Strong World,49271461,0,49271461,2009.csv,2009,0.0,1.0
2358,Entourage,49263404,32363404,16900000,2015.csv,2015,0.6569461582476112,0.34305384175238884
2359,A Turtle's Tale 2: Sammy's Escape from Paradise,49261830,0,49261830,2012.csv,2012,0.0,1.0
2360,The Hurt Locker,49230772,17017811,32212961,2008.csv,2008,0.3456742664933225,0.6543257335066774
2361,The New Mutants,49169594,23852659,25316935,2020.csv,2020,0.4851099441659006,0.5148900558340994
2362,Death at a Funeral,49050886,42739347,6311539,2010.csv,2010,0.8713267075338863,0.12867329246611367
2363,Little,48987096,40860481,8126615,2019.csv,2019,0.8341070268790786,0.16589297312092147
2364,Whiplash,48982041,13092000,35890041,2014.csv,2014,0.2672816349159481,0.732718365084052
2365,Never Gone,48980792,96421,48884371,2016.csv,2016,0.0019685471806989156,0.9980314528193011
2366,The Berlin File,48972848,665210,48307638,2013.csv,2013,0.013583241064518036,0.986416758935482
2367,Trouble with the Curve,48963137,35763137,13200000,2012.csv,2012,0.7304094302617906,0.2695905697382094
2368,Luck-Key,48913975,466505,48447470,2016.csv,2016,0.00953725392385305,0.9904627460761469
2369,Florence Foster Jenkins,48902953,27383770,21519183,2016.csv,2016,0.559961481262696,0.44003851873730404
2370,Push,48858618,31811527,17047091,2009.csv,2009,0.6510934672773594,0.34890653272264066
2371,The Woman in Black 2: Angel of Death,48854305,26501323,22352982,2015.csv,2015,0.5424562482262311,0.457543751773769
2372,Bleeding Steel,48825526,0,48825526,2017.csv,2017,0.0,1.0
2373,Fantasy Island,48811343,27309289,21502054,2020.csv,2020,0.5594865316449088,0.44051346835509114
2374,Isn't It Romantic,48791187,48791187,0,2019.csv,2019,1.0,0.0
2375,Mother's Day,48782670,32492859,16289811,2016.csv,2016,0.6660738126879894,0.33392618731201057
2376,How Do You Know,48668907,30212620,18456287,2010.csv,2010,0.6207786831950017,0.3792213168049983
2377,Concussion,48623572,34542474,14081098,2015.csv,2015,0.7104059323325732,0.28959406766742685
2378,The Last King of Scotland,48618191,17606684,31011507,2006.csv,2006,0.36214189869795854,0.6378581013020415
2379,Shutter,48555306,25928550,22626756,2008.csv,2008,0.534000341795807,0.465999658204193
2380,Fat Albert,48551322,48116322,435000,2004.csv,2004,0.9910404087452037,0.008959591254796317
2381,Her,48517427,25568251,22949176,2013.csv,2013,0.5269910747740189,0.47300892522598115
2382,The Legend of Hei,48507082,0,48507082,2019.csv,2019,0.0,1.0
2383,Logan Lucky,48453605,27780977,20672628,2017.csv,2017,0.5733521169374292,0.4266478830625709
2384,Magnolia,48451803,22455976,25995827,1999.csv,1999,0.4634703893268946,0.5365296106731055
2385,Homefront,48449416,20158898,28290518,2013.csv,2013,0.4160813414138986,0.5839186585861015
2386,Mr. Brooks,48443734,28549298,19894436,2007.csv,2007,0.5893290141507259,0.41067098584927414
2387,9,48428063,31749894,16678169,2009.csv,2009,0.6556094139053218,0.3443905860946782
2388,Chef,48428048,31424003,17004045,2014.csv,2014,0.6488802315550691,0.3511197684449309
2389,20th Century Boys 3: Redemption,48397818,0,48397818,2009.csv,2009,0.0,1.0
2390,Belfast,48353189,9250870,39102319,2021.csv,2021,0.19131871529714412,0.8086812847028559
2391,"Girl, Interrupted",48350205,28912646,19437559,1999.csv,1999,0.5979839382273561,0.402016061772644
2392,Boo 2! A Madea Halloween,48333932,47319572,1014360,2017.csv,2017,0.979013501322425,0.020986498677575
2393,The Last Stand,48330757,12050299,36280458,2013.csv,2013,0.24932982117370933,0.7506701788262907
2394,Secondhand Lions,48249017,42070939,6178078,2003.csv,2003,0.8719543239606311,0.12804567603936884
2395,Charlie St. Cloud,48190704,31162545,17028159,2010.csv,2010,0.6466505448851713,0.3533494551148288
2396,Arthur,48147945,33035397,15112548,2011.csv,2011,0.6861226787560715,0.3138773212439285
2397,Boyhood,48137666,25352281,22785385,2014.csv,2014,0.5266620321807874,0.4733379678192125
2398,Suite Dreams,48090431,0,48090431,2006.csv,2006,0.0,1.0
2399,21 & Over,48065672,25682380,22383292,2013.csv,2013,0.5343185465086184,0.4656814534913815
2400,Sky Hunter,48065601,0,48065601,2017.csv,2017,0.0,1.0
2401,Heartbreaker,48023509,504030,47519479,2010.csv,2010,0.010495484617752526,0.9895045153822475
2402,Countdown,48021766,25621766,22400000,2019.csv,2019,0.5335448513076341,0.4664551486923659
2403,After We Collided,47990414,2386483,45603931,2020.csv,2020,0.04972832699463689,0.9502716730053631
2404,Death Note: The Last Name,47917637,0,47917637,2006.csv,2006,0.0,1.0
2405,"From Today, It's My Turn: The Movie",47895887,0,47895887,2020.csv,2020,0.0,1.0
2406,Midsommar,47863365,27426361,20437004,2019.csv,2019,0.5730136399728686,0.4269863600271314
2407,Queen & Slim,47861328,43808310,4053018,2019.csv,2019,0.9153174771916065,0.08468252280839345
2408,The Nanny Diaries,47817020,25930652,21886368,2007.csv,2007,0.5422891681664813,0.4577108318335187
2409,Phantom Thread,47756590,21198205,26558385,2017.csv,2017,0.4438802058522185,0.5561197941477815
2410,Son of a Rich,47738868,0,47738868,2019.csv,2019,0.0,1.0
2411,Book of Shadows: Blair Witch 2,47737094,26437094,21300000,2000.csv,2000,0.5538061030694496,0.4461938969305505
2412,The Fourth Kind,47709193,25486040,22223153,2009.csv,2009,0.5341955794557246,0.4658044205442754
2413,Scott Pilgrim vs. the World,47664559,31524275,16140284,2010.csv,2010,0.6613776705665104,0.3386223294334896
2414,Trolls 2: World Tour,47648334,450000,47198334,2020.csv,2020,0.009444191689892033,0.9905558083101079
2415,"Yo-kai Watch Movie: It's the Secret of Birth, Meow! 2016 Re-release",47642462,0,47642462,2016.csv,2016,0.0,1.0
2416,Man on a Ledge,47636031,18620000,29016031,2012.csv,2012,0.3908805920459662,0.6091194079540337
2417,Inside Men,47616503,0,47616503,2015.csv,2015,0.0,1.0
2418,The Dead End,47600000,0,47600000,2015.csv,2015,0.0,1.0
2419,Coming Home,47587984,377607,47210377,2014.csv,2014,0.007934923236084135,0.9920650767639159
2420,47 Meters Down: Uncaged,47582563,22260900,25321663,2019.csv,2019,0.46783734621441053,0.5321626537855895
2421,Boonie Bears Winter,47581416,0,47581416,2015.csv,2015,0.0,1.0
2422,Pokémon: Giratina and the Sky Warrior,47505623,0,47505623,2008.csv,2008,0.0,1.0
2423,A Walk to Remember,47494916,41281092,6213824,2002.csv,2002,0.8691686495455639,0.130831350454436
2424,Darkness Falls,47488536,32551396,14937140,2003.csv,2003,0.685457980848262,0.314542019151738
2425,Man on the Moon,47434430,34607430,12827000,1999.csv,1999,0.7295846076362675,0.2704153923637324
2426,Beauty and the Beast,47430624,0,47430624,2014.csv,2014,0.0,1.0
2427,The Magic Tuche,47427990,0,47427990,2018.csv,2018,0.0,1.0
2428,Crazy Heart,47405566,39464306,7941260,2009.csv,2009,0.8324825401304142,0.16751745986958577
2429,Nightcrawler,47398992,32381217,15017775,2014.csv,2014,0.683162565988745,0.3168374340112549
2430,Almost Famous,47383689,32534850,14848839,2000.csv,2000,0.6866255179076496,0.31337448209235036
2431,Rough Night,47347283,22105643,25241640,2017.csv,2017,0.466883031070653,0.533116968929347
2432,Texas Chainsaw,47340586,34341945,12998641,2013.csv,2013,0.7254228961170865,0.2745771038829135
2433,Broken Flowers,47329961,13744960,33585001,2005.csv,2005,0.29040716936149596,0.709592830638504
2434,Don't Breathe 2,47312950,32712950,14600000,2021.csv,2021,0.6914164092494761,0.3085835907505239
2435,A Monster Calls,47309313,3740823,43568490,2016.csv,2016,0.07907159843982516,0.9209284015601749
2436,Tiny Times 2.0,47289937,43788,47246149,2013.csv,2013,0.0009259475224084143,0.9990740524775916
2437,Golden Job,47287851,285795,47002056,2018.csv,2018,0.006043729921243407,0.9939562700787566
2438,Mortdecai,47275695,7696134,39579561,2015.csv,2015,0.16279261468287246,0.8372073853171276
2439,The Watcher,47267829,28946615,18321214,2000.csv,2000,0.612395695177792,0.3876043048222079
2440,Deck the Halls,47232776,35093569,12139207,2006.csv,2006,0.7429918791984617,0.25700812080153834
2441,Switch,47164301,0,47164301,2013.csv,2013,0.0,1.0
2442,High Fidelity,47126295,27287137,19839158,2000.csv,2000,0.5790214783487647,0.4209785216512353
2443,Soul Surfer,47120948,43853424,3267524,2011.csv,2011,0.9306566582658736,0.0693433417341264
2444,The Wedding Date,47096206,31726995,15369211,2005.csv,2005,0.6736635006225342,0.3263364993774658
2445,Land of the Dead,47074133,20700082,26374051,2005.csv,2005,0.4397336855890686,0.5602663144109313
2446,Dracula 2000,47053625,33022767,14030858,2000.csv,2000,0.7018113269700262,0.29818867302997376
2447,The Place Beyond the Pines,47052899,21403519,25649380,2013.csv,2013,0.45488204669387106,0.5451179533061289
2448,Son of Bigfoot,47046281,289308,46756973,2017.csv,2017,0.006149434000957483,0.9938505659990425
2449,StreetDance 2,46960833,0,46960833,2010.csv,2010,0.0,1.0
2450,My Hero Academia: World Heroes' Mission,46951862,12271658,34680204,2021.csv,2021,0.26136680159777265,0.7386331984022274
2451,Parker,46922566,17616641,29305925,2013.csv,2013,0.3754406994706982,0.6245593005293019
2452,Death at a Funeral,46789413,8580428,38208985,2007.csv,2007,0.18338396337650142,0.8166160366234986
2453,Hachi: A Dog's Tale,46748131,0,46748131,2009.csv,2009,0.0,1.0
2454,Mary Queen of Scots,46712809,16468499,30244310,2018.csv,2018,0.35254782044899075,0.6474521795510092
2455,Uncle Drew,46664414,42469946,4194468,2018.csv,2018,0.9101142039413588,0.08988579605864118
2456,Be with You,46616207,0,46616207,2004.csv,2004,0.0,1.0
2457,Three Seconds,46596415,0,46596415,2017.csv,2017,0.0,1.0
2458,Get Rich or Die Tryin',46563961,30985352,15578609,2005.csv,2005,0.6654363446443055,0.3345636553556945
2459,Torque,46546197,21215059,25331138,2003.csv,2003,0.45578501289804624,0.5442149871019538
2460,The Big Wedding,46522137,21819348,24702789,2013.csv,2013,0.4690100112984922,0.5309899887015078
2461,Badges of Fury,46495296,0,46495296,2013.csv,2013,0.0,1.0
2462,Fantastic Mr. Fox,46471023,21002919,25468104,2009.csv,2009,0.45195731972588593,0.5480426802741141
2463,Zweiohrküken,46439905,0,46439905,2009.csv,2009,0.0,1.0
2464,Risen,46432579,36880033,9552546,2016.csv,2016,0.7942706133122608,0.20572938668773924
2465,The Nativity Story,46432264,37629831,8802433,2006.csv,2006,0.8104242127844552,0.18957578721554477
2466,Acrimony,46403669,43549096,2854573,2018.csv,2018,0.9384838944523978,0.061516105547602284
2467,The French Dispatch,46333545,16124375,30209170,2021.csv,2021,0.348006503711296,0.651993496288704
2468,A Werewolf Boy,46282588,342922,45939666,2012.csv,2012,0.007409309090494248,0.9925906909095058
2469,The Thousand Faces of Dunjia,46263237,124187,46139050,2017.csv,2017,0.002684356047113608,0.9973156439528864
2470,The Fog,46201432,29550869,16650563,2005.csv,2005,0.6396093740124765,0.3603906259875235
2471,The Battleship Island,46183383,1104957,45078426,2017.csv,2017,0.023925423566307388,0.9760745764336927
2472,Doraemon: Nobita and the Island of Miracles ~Animal Adventure~,46180706,0,46180706,2012.csv,2012,0.0,1.0
2473,Hanson and the Beast,46154323,0,46154323,2017.csv,2017,0.0,1.0
2474,Eddie the Eagle,46152800,15789389,30363411,2016.csv,2016,0.342111182853478,0.657888817146522
2475,Napoleon Dynamite,46118097,44540956,1577141,2004.csv,2004,0.9658021231882139,0.03419787681178606
2476,Into the Blue,46117696,18801234,27316462,2005.csv,2005,0.4076793862382024,0.5923206137617977
2477,For Love of the Game,46112640,35188640,10924000,1999.csv,1999,0.7631018306477356,0.23689816935226438
2478,The World's End,46089287,26004851,20084436,2013.csv,2013,0.5642276696534707,0.43577233034652935
2479,The Hunted,46061847,34244097,11817750,2003.csv,2003,0.7434373398009854,0.2565626601990146
2480,Gekijouban Tenpesuto 3D 2012 Re-release,46008255,0,46008255,2012.csv,2012,0.0,1.0
2481,Let's Get Married,45972724,462918,45509806,2015.csv,2015,0.010069405502271303,0.9899305944977287
2482,Asterix: The Secret of the Magic Potion,45972321,1271953,44700368,2018.csv,2018,0.027667800370575157,0.9723321996294249
2483,Welcome to the South,45896492,0,45896492,2010.csv,2010,0.0,1.0
2484,Eight Legged Freaks,45867333,17322606,28544727,2002.csv,2002,0.37766760932012333,0.6223323906798767
2485,One Missed Call,45847751,26890041,18957710,2008.csv,2008,0.5865073076321672,0.4134926923678328
2486,Gintama Live Action the Movie,45746967,0,45746967,2017.csv,2017,0.0,1.0
2487,Somewhere Only We Know,45737711,482341,45255370,2015.csv,2015,0.010545805407708313,0.9894541945922917
2488,Chasing the Dragon II: Wild Wild Bunch,45733356,196634,45536722,2019.csv,2019,0.004299575128490461,0.9957004248715096
2489,"McFarland, USA",45710059,44482410,1227649,2015.csv,2015,0.9731426949153577,0.026857305084642312
2490,Judy,45701880,24313888,21387992,2019.csv,2019,0.5320106743967644,0.4679893256032356
2491,Guilty of Mind,45698503,0,45698503,2017.csv,2017,0.0,1.0
2492,Earth to Echo,45681062,38934842,6746220,2014.csv,2014,0.8523191076424624,0.14768089235753756
2493,That Awkward Moment,45640143,26068955,19571188,2014.csv,2014,0.5711847791537376,0.42881522084626245
2494,The Debt,45636368,31177548,14458820,2011.csv,2011,0.6831732972264576,0.31682670277354236
2495,Bajrangi Bhaijaan 2018 Re-release,45579004,0,45579004,2018.csv,2018,0.0,1.0
2496,Hero,45565534,88675,45476859,2015.csv,2015,0.0019460981188105905,0.9980539018811894
2497,If You Are the One,45521453,0,45521453,2008.csv,2008,0.0,1.0
2498,Machete,45491656,26593646,18898010,2010.csv,2010,0.5845829397813085,0.4154170602186915
2499,Queen of the Damned,45479110,30336800,15142310,2002.csv,2002,0.6670491133181806,0.33295088668181944
2500,Love on the Cloud,45386560,271734,45114826,2014.csv,2014,0.005987102789900799,0.9940128972100992
2501,Good Boy,45312217,37667746,7644471,2003.csv,2003,0.8312933794433408,0.16870662055665914
2502,The Last House on the Left,45289053,32752215,12536838,2009.csv,2009,0.7231817145746015,0.2768182854253985
2503,The Spy Next Door,45236543,24307086,20929457,2009.csv,2009,0.5373329699398117,0.4626670300601883
2504,Tanhaji: The Unsung Warrior,45221814,0,45221814,2020.csv,2020,0.0,1.0
2505,Confessions,45203103,0,45203103,2010.csv,2010,0.0,1.0
2506,Blair Witch,45173154,20777061,24396093,2016.csv,2016,0.4599426686035693,0.5400573313964308
2507,Flatliners,45158254,16883115,28275139,2017.csv,2017,0.3738655396198445,0.6261344603801555
2508,Boonie Bears: The Big Top Secret,45150390,0,45150390,2016.csv,2016,0.0,1.0
2509,In the Heights,45135827,29975167,15160660,2021.csv,2021,0.6641102864914827,0.3358897135085173
2510,Deuce Bigalow: European Gigolo,45109561,22400154,22709407,2005.csv,2005,0.49657220117925777,0.5034277988207423
2511,Love Will Tear Us Apart,45060290,0,45060290,2021.csv,2021,0.0,1.0
2512,Monster's Ball,44909486,31273922,13635564,2001.csv,2001,0.6963767521186949,0.30362324788130507
2513,Grudge Match,44907260,29807260,15100000,2013.csv,2013,0.6637514735924659,0.3362485264075341
2514,Child's Play,44907074,29208403,15698671,2019.csv,2019,0.6504187513976083,0.3495812486023917
2515,Nodame Cantabile: The Movie II,44879450,0,44879450,2009.csv,2009,0.0,1.0
2516,Avatar 2010 Special Edition,44838548,10741486,34097062,2010.csv,2010,0.239559184655132,0.760440815344868
2517,Still Alice,44779195,18754371,26024824,2015.csv,2015,0.41881885103115407,0.5811811489688459
2518,The Wrestler,44734660,26238243,18496417,2008.csv,2008,0.5865305112411718,0.41346948875882816
2519,The Man from Nowhere,44723232,528175,44195057,2010.csv,2010,0.011809857570222116,0.9881901424297779
2520,The White Storm,44670277,0,44670277,2013.csv,2013,0.0,1.0
2521,Richard Jewell,44655962,22345542,22310420,2019.csv,2019,0.5003932509616521,0.4996067490383479
2522,Lakeview Terrace,44655002,39263506,5391496,2008.csv,2008,0.8792633353817787,0.12073666461822127
2523,Uptown Girls,44617342,37182494,7434848,2003.csv,2003,0.8333641658886807,0.16663583411131933
2524,The Gift,44567606,12008642,32558964,2000.csv,2000,0.2694477688570483,0.7305522311429516
2525,Bad Genius,44560421,0,44560421,2017.csv,2017,0.0,1.0
2526,Mother!,44516999,17800004,26716995,2017.csv,2017,0.3998473482006278,0.6001526517993722
2527,Recess: School's Out,44460850,36706141,7754709,2001.csv,2001,0.8255834290167642,0.17441657098323582
2528,Oculus,44446287,27695246,16751041,2014.csv,2014,0.6231172021185931,0.37688279788140683
2529,Notorious,44420167,36843682,7576485,2009.csv,2009,0.8294359181495198,0.17056408185048022
2530,Detective Conan: The Eleventh Striker,44369456,0,44369456,2012.csv,2012,0.0,1.0
2531,The Sisterhood of the Traveling Pants 2,44352417,44089964,262453,2008.csv,2008,0.9940825547342775,0.005917445265722497
2532,A Man Apart,44350926,26736098,17614828,2003.csv,2003,0.6028306601760693,0.3971693398239306
2533,Dark Water 2005 Re-release,44347079,25473352,18873727,2005.csv,2005,0.5744087902610227,0.4255912097389774
2534,Moonfall,44345119,19060660,25284459,2022.csv,2022,0.4298254335499697,0.5701745664500303
2535,Unhinged,44331465,20831465,23500000,2020.csv,2020,0.4699024722056896,0.5300975277943104
2536,House at the End of the Street,44287131,31611916,12675215,2012.csv,2012,0.7137946235442526,0.2862053764557474
2537,The Girl Who Kicked the Hornet's Nest,44276335,5190196,39086139,2009.csv,2009,0.11722280084835386,0.8827771991516461
2538,The Good the Bad the Weird,44261209,128486,44132723,2008.csv,2008,0.0029029030815674287,0.9970970969184326
2539,Hardball,44102389,40222729,3879660,2001.csv,2001,0.912030615847137,0.08796938415286301
2540,Tarzan,44095996,0,44095996,2013.csv,2013,0.0,1.0
2541,The Great Hypnotist,44077818,0,44077818,2014.csv,2014,0.0,1.0
2542,Winchester,44019588,25091816,18927772,2018.csv,2018,0.5700147852360635,0.4299852147639365
2543,Semi-Pro,44004502,33479698,10524804,2008.csv,2008,0.7608243811053697,0.23917561889463038
2544,Kick,43996483,2472695,41523788,2014.csv,2014,0.056202105972879696,0.9437978940271203
2545,Wind River,43980821,33800859,10179962,2017.csv,2017,0.7685363354176585,0.23146366458234147
2546,Max,43967255,42656255,1311000,2015.csv,2015,0.9701823550276223,0.029817644972377738
2547,The End of Endless Love,43950000,0,43950000,2020.csv,2020,0.0,1.0
2548,Timeline,43935763,19481943,24453820,2003.csv,2003,0.4434187930228957,0.5565812069771042
2549,The Transporter,43928932,25296447,18632485,2002.csv,2002,0.5758493514023969,0.42415064859760304
2550,Battle of Memories,43892362,594552,43297810,2017.csv,2017,0.01354568250393998,0.98645431749606
2551,Of Gods and Men,43803417,3951596,39851821,2010.csv,2010,0.09021204898238874,0.9097879510176112
2552,Café Society,43763247,11103205,32660042,2016.csv,2016,0.25371072215002693,0.746289277849973
2553,The DUFF,43709744,34030343,9679401,2015.csv,2015,0.7785527867653491,0.22144721323465083
2554,The Sea Inside,43685449,2104923,41580526,2004.csv,2004,0.04818361830274424,0.9518163816972558
2555,"Welcome Home, Roscoe Jenkins",43655418,42436517,1218901,2008.csv,2008,0.9720790441177313,0.027920955882268724
2556,Boy,43551154,256211,43294943,2010.csv,2010,0.005882989920313018,0.994117010079687
2557,We Are Marshall,43545364,43545364,0,2006.csv,2006,1.0,0.0
2558,League of Gods,43498766,181633,43317133,2016.csv,2016,0.004175589716728976,0.9958244102832711
2559,Harold & Kumar Escape from Guantanamo Bay,43495888,38108728,5387160,2008.csv,2008,0.8761455335731966,0.12385446642680338
2560,Brothers,43474578,28544157,14930421,2009.csv,2009,0.6565712265223138,0.3434287734776862
2561,Last Holiday,43451846,38399961,5051885,2006.csv,2006,0.8837360097428312,0.11626399025716883
2562,Secretly Greatly,43447199,0,43447199,2013.csv,2013,0.0,1.0
2563,The Master of Disguise,43411001,40388794,3022207,2002.csv,2002,0.9303815408449116,0.06961845915508837
2564,In the Bedroom,43368779,35930604,7438175,2001.csv,2001,0.8284900988335411,0.17150990116645895
2565,Harriet,43347017,43082155,264862,2019.csv,2019,0.9938897294824232,0.006110270517576792
2566,The Duchess,43343384,13848978,29494406,2008.csv,2008,0.31951769155818566,0.6804823084418143
2567,Orange County,43325009,41076018,2248991,2002.csv,2002,0.94809023582661,0.051909764173390015
2568,Beastly,43202283,27865571,15336712,2011.csv,2011,0.6450022791619601,0.35499772083804
2569,The Snowman,43155261,6700035,36455226,2017.csv,2017,0.1552541878961177,0.8447458121038823
2570,A Shaun the Sheep Movie: Farmageddon,43100248,0,43100248,2019.csv,2019,0.0,1.0
2571,Freedom Writers,43095175,36605602,6489573,2007.csv,2007,0.8494130027317444,0.15058699726825567
2572,Annihilation,43070915,32732301,10338614,2018.csv,2018,0.7599629819798349,0.2400370180201651
2573,See Spot Run,43057552,33357476,9700076,2001.csv,2001,0.7747183583497733,0.22528164165022665
2574,When in Rome,43053376,32680633,10372743,2010.csv,2010,0.7590724824924299,0.24092751750757013
2575,Gifted,43046590,24801212,18245378,2017.csv,2017,0.5761481223019059,0.42385187769809407
2576,The Possession of Hannah Grace,43016528,14837422,28179106,2018.csv,2018,0.3449237465190124,0.6550762534809876
2577,Legend,42972994,1872994,41100000,2015.csv,2015,0.04358537364187378,0.9564146263581262
2578,"The Chef, The Actor, The Scoundrel",42970000,0,42970000,2013.csv,2013,0.0,1.0
2579,The Gallows,42964410,22764410,20200000,2015.csv,2015,0.5298434215668271,0.47015657843317293
2580,Glory Road,42938449,42647449,291000,2006.csv,2006,0.9932228572112607,0.006777142788739295
2581,Crank,42931041,27838408,15092633,2006.csv,2006,0.6484447465413196,0.3515552534586804
2582,A Lot Like Love,42886719,21845719,21041000,2005.csv,2005,0.5093819137808141,0.49061808621918596
2583,The Warlords,42883181,129078,42754103,2007.csv,2007,0.0030099912597435345,0.9969900087402565
2584,Asterix and Obelix: Mansion of the Gods,42830578,0,42830578,2014.csv,2014,0.0,1.0
2585,Detective Conan: Quarter of Silence,42808575,0,42808575,2011.csv,2011,0.0,1.0
2586,Basic,42792561,26793311,15999250,2003.csv,2003,0.6261207643076094,0.37387923569239057
2587,Zack and Miri Make a Porno,42782463,31457946,11324517,2008.csv,2008,0.735300022347942,0.26469997765205805
2588,Shaolin Soccer,42776760,489600,42287160,2001.csv,2001,0.01144546711812676,0.9885545328818732
2589,Doraemon: Nobita's Secret Gadget Museum,42770271,0,42770271,2013.csv,2013,0.0,1.0
2590,Shaolin,42741494,66099,42675395,2011.csv,2011,0.001546483143523247,0.9984535168564768
2591,Spirit Untamed,42717215,17716215,25001000,2021.csv,2021,0.4147324445191476,0.5852675554808524
2592,Peninsula,42698327,1231407,41466920,2020.csv,2020,0.02883970137752704,0.971160298622473
2593,House on Haunted Hill,42593455,40846082,1747373,1999.csv,1999,0.9589755515254632,0.041024448474536755
2594,Almost Christmas,42580920,42158780,422140,2016.csv,2016,0.9900861700498721,0.009913829950127897
2595,Oliver Twist,42580321,2080321,40500000,2005.csv,2005,0.04885639542266485,0.9511436045773352
2596,Pokémon: The Rise of Darkrai,42496749,0,42496749,2007.csv,2007,0.0,1.0
2597,Bangkok Dangerous,42487390,15298133,27189257,2008.csv,2008,0.36006290336968216,0.6399370966303178
2598,Thermae Romae II,42473163,0,42473163,2014.csv,2014,0.0,1.0
2599,Man of the Year,42472472,37327390,5145082,2006.csv,2006,0.8788607830502543,0.1211392169497457
2600,Love the Coopers,42426912,26302731,16124181,2015.csv,2015,0.6199539339558816,0.3800460660441184
2601,8 Women,42426583,3098776,39327807,2002.csv,2002,0.0730385475540182,0.9269614524459818
2602,My Name Is Khan,42345360,4018771,38326589,2010.csv,2010,0.09490463654105195,0.905095363458948
2603,Always: Sunset on Third Street 2,42304705,0,42304705,2007.csv,2007,0.0,1.0
2604,A Good Year,42269923,7459300,34810623,2006.csv,2006,0.17646826562707482,0.8235317343729252
2605,Loving Vincent,42187665,6735118,35452547,2017.csv,2017,0.15964661708582353,0.8403533829141765
2606,The Throne,42165755,0,42165755,2015.csv,2015,0.0,1.0
2607,Monster Hunter,42145959,15162470,26983489,2020.csv,2020,0.3597609441037989,0.6402390558962011
2608,Long Day's Journey Into Night,42140994,521365,41619629,2018.csv,2018,0.01237191984602926,0.9876280801539707
2609,Jobs,42128352,16131410,25996942,2013.csv,2013,0.3829110144161348,0.6170889855838653
2610,Going the Distance,42059111,17804299,24254812,2010.csv,2010,0.4233161038520286,0.5766838961479713
2611,Bang Bang,42045981,2546172,39499809,2014.csv,2014,0.060556846087144456,0.9394431539128556
2612,Detective Conan: The Sniper from Another Dimension,42028116,0,42028116,2014.csv,2014,0.0,1.0
2613,The Sisterhood of the Traveling Pants,42013878,39053061,2960817,2005.csv,2005,0.9295276432230322,0.07047235677696784
2614,200 Pounds Beauty,42013016,0,42013016,2006.csv,2006,0.0,1.0
2615,Mary and the Witch's Flower,41978431,2418404,39560027,2017.csv,2017,0.05761063342267366,0.9423893665773263
2616,Meet the Browns,41975388,41975388,0,2008.csv,2008,1.0,0.0
2617,Rurouni Kenshin: The Legend Ends,41900000,0,41900000,2014.csv,2014,0.0,1.0
2618,"As Above, So Below",41898409,21321100,20577309,2014.csv,2014,0.5088761246280259,0.49112387537197416
2619,Call Me by Your Name,41887595,18095701,23791894,2017.csv,2017,0.4320062061333433,0.5679937938666567
2620,The Guilt Trip,41863726,37134215,4729511,2012.csv,2012,0.8870260377683534,0.11297396223164656
2621,No Man's Land,41807712,0,41807712,2013.csv,2013,0.0,1.0
2622,The Informant!,41771168,33316821,8454347,2009.csv,2009,0.7976032894268122,0.2023967105731877
2623,Scandal Makers,41745790,0,41745790,2008.csv,2008,0.0,1.0
2624,Balls of Fury,41739111,32886940,8852171,2007.csv,2007,0.7879166377070178,0.21208336229298225
2625,Fly Me to the Moon 3D,41721414,13816982,27904432,2008.csv,2008,0.33117242862382373,0.6688275713761763
2626,Wimbledon,41682237,17001133,24681104,2004.csv,2004,0.4078747740914193,0.5921252259085806
2627,T2 Trainspotting,41681746,2402004,39279742,2017.csv,2017,0.05762724047116452,0.9423727595288355
2628,Overlord,41657844,21704844,19953000,2018.csv,2018,0.5210265802522089,0.47897341974779106
2629,Born to Be Wild,41644475,25978556,15665919,2011.csv,2011,0.6238175892480335,0.3761824107519665
2630,The Uninvited,41633384,28596818,13036566,2009.csv,2009,0.6868722945989689,0.3131277054010311
2631,Never Back Down,41627431,24850922,16776509,2008.csv,2008,0.5969842818308918,0.40301571816910825
2632,My Best Friend's Girl,41624687,19219250,22405437,2008.csv,2008,0.4617271956903844,0.5382728043096155
2633,Undercover Brother,41604473,39089928,2514545,2002.csv,2002,0.9395607054078056,0.06043929459219445
2634,Safe,41564670,17142080,24422590,2012.csv,2012,0.4124194899177595,0.5875805100822405
2635,Escape Captivity: The Movie,41550983,0,41550983,2008.csv,2008,0.0,1.0
2636,The Great Battle,41509280,472166,41037114,2018.csv,2018,0.0113749503725432,0.9886250496274568
2637,Gridiron Gang,41480851,38432823,3048028,2006.csv,2006,0.9265196367355144,0.07348036326448558
2638,Lupin III vs. Detective Conan: The Movie,41397727,0,41397727,2013.csv,2013,0.0,1.0
2639,The Lady in the Van,41387687,10021175,31366512,2015.csv,2015,0.24212938017048405,0.757870619829516
2640,Shark Night,41363927,18877153,22486774,2011.csv,2011,0.45636752525938845,0.5436324747406115
2641,Ricki and the Flash,41325328,26822144,14503184,2015.csv,2015,0.6490485447568619,0.35095145524313803
2642,Quarantine,41319906,31691811,9628095,2008.csv,2008,0.7669865221861831,0.2330134778138169
2643,Leatherheads,41319039,31373938,9945101,2008.csv,2008,0.7593094795839758,0.2406905204160242
2644,Pinocchio,41314585,3675719,37638866,2002.csv,2002,0.08896904083630515,0.9110309591636948
2645,This Is Where I Leave You,41296320,34296320,7000000,2014.csv,2014,0.8304933708378858,0.1695066291621142
2646,Toy Story 2009 Re-release,41258298,30702446,10555852,2009.csv,2009,0.744152024884788,0.25584797511521196
2647,Evangelion: 2.0 You Can (Not) Advance,41162041,133640,41028401,2009.csv,2009,0.0032466806007019912,0.996753319399298
2648,The Concert,41146351,657986,40488365,2009.csv,2009,0.01599135728949573,0.9840086427105043
2649,The Darkest Minds,41142379,12695691,28446688,2018.csv,2018,0.30857940908084097,0.6914205909191591
2650,50/50,41097853,35014192,6083661,2011.csv,2011,0.8519713183070659,0.14802868169293418
2651,Fist Fight,41087017,32187017,8900000,2017.csv,2017,0.7833865622320549,0.21661343776794503
2652,Arlington Road,41067311,24756177,16311134,1999.csv,1999,0.6028195271903729,0.3971804728096271
2653,Whale Rider,41062976,20779666,20283310,2003.csv,2003,0.5060438386151067,0.4939561613848933
2654,Nodame Cantabile: The Movie II 2010 Re-release,41054604,0,41054604,2010.csv,2010,0.0,1.0
2655,"Lost, Found",41043552,0,41043552,2018.csv,2018,0.0,1.0
2656,Dredd,41037742,13414714,27623028,2012.csv,2012,0.32688723468264896,0.6731127653173511
2657,Fright Night,41002607,18302607,22700000,2011.csv,2011,0.4463766657568871,0.5536233342431128
2658,Twisted,40954603,25198598,15756005,2004.csv,2004,0.6152812175959806,0.3847187824040194
2659,Breach,40953935,33231264,7722671,2007.csv,2007,0.8114303057813614,0.18856969421863856
2660,La vérité si je mens! 3,40928635,0,40928635,2012.csv,2012,0.0,1.0
2661,Always: Sunset on Third Street '64,40923305,0,40923305,2012.csv,2012,0.0,1.0
2662,Drive Angry,40909909,10721033,30188876,2011.csv,2011,0.262064454848824,0.737935545151176
2663,Underwater,40882928,17291078,23591850,2020.csv,2020,0.4229412824834855,0.5770587175165145
2664,The Love Guru,40877556,32235793,8641763,2008.csv,2008,0.7885939413794699,0.21140605862053005
2665,Where the Heart Is,40863718,33772838,7090880,2000.csv,2000,0.8264749184105078,0.17352508158949217
2666,Gamer,40828540,20534907,20293633,2009.csv,2009,0.5029547223584286,0.4970452776415713
2667,Fighting with My Family,40812363,22958886,17853477,2019.csv,2019,0.5625473340026893,0.43745266599731064
2668,The War with Grandpa,40800804,21277892,19522912,2020.csv,2020,0.5215066840349518,0.4784933159650481
2669,30 Minutes or Less,40662632,37053924,3608708,2011.csv,2011,0.9112524737700206,0.0887475262299794
2670,The Circle,40656399,20497844,20158555,2017.csv,2017,0.504172639588666,0.495827360411334
2671,Spiral,40618920,23216862,17402058,2021.csv,2021,0.571577530864927,0.42842246913507304
2672,Spanish Affair 2,40591862,0,40591862,2015.csv,2015,0.0,1.0
2673,Gantz,40568961,0,40568961,2011.csv,2011,0.0,1.0
2674,The Roommate,40492652,37300000,3192652,2011.csv,2011,0.9211547813662587,0.07884521863374125
2675,War,40481352,22486409,17994943,2007.csv,2007,0.5554757410276218,0.4445242589723782
2676,Holmes & Watson,40466970,30573626,9893344,2018.csv,2018,0.7555205146320567,0.24447948536794328
2677,Serenity,40445129,25514517,14930612,2005.csv,2005,0.6308427647739732,0.36915723522602684
2678,Bless the Child,40443010,29381494,11061516,2000.csv,2000,0.7264912774790996,0.2735087225209004
2679,The Ringer,40442443,35428675,5013768,2005.csv,2005,0.8760270738342884,0.12397292616571161
2680,The Witch,40423945,25138705,15285240,2016.csv,2016,0.6218765882449128,0.37812341175508724
2681,The Boy in the Striped Pajamas,40416563,9046156,31370407,2008.csv,2008,0.22382299058927896,0.7761770094107211
2682,The Art of War,40400425,30208599,10191826,2000.csv,2000,0.7477297330411747,0.2522702669588253
2683,Masquerade Hotel,40396244,0,40396244,2019.csv,2019,0.0,1.0
2684,Bad Education,40350837,5211842,35138995,2004.csv,2004,0.12916316952731366,0.8708368304726863
2685,Magnificent Desolation: Walking on the Moon,40339402,34137524,6201878,2005.csv,2005,0.8462575622712504,0.15374243772874968
2686,Carol,40272135,12711491,27560644,2015.csv,2015,0.3156398586764769,0.6843601413235231
2687,Yolki 3,40267368,0,40267368,2013.csv,2013,0.0,1.0
2688,Blast from the Past,40263020,26511114,13751906,1999.csv,1999,0.6584482237050276,0.3415517762949724
2689,SP: The Motion Picture II,40255101,0,40255101,2011.csv,2011,0.0,1.0
2690,The Invasion,40170558,15074191,25096367,2007.csv,2007,0.37525470768914887,0.6247452923108512
2691,Boonie Bears: To the Rescue,40163675,0,40163675,2014.csv,2014,0.0,1.0
2692,Crimson Rivers 2: Angels of the Apocalypse,40152148,152148,40000000,2004.csv,2004,0.0037892866902164237,0.9962107133097836
2693,Diary of a Wimpy Kid: The Long Haul,40140972,20738724,19402248,2017.csv,2017,0.5166472799911273,0.48335272000887275
2694,All About Steve,40105542,33862903,6242639,2009.csv,2009,0.8443447292147305,0.15565527078526953
2695,The Wild Life,40075446,8005586,32069860,2016.csv,2016,0.19976286726790266,0.8002371327320974
2696,Snake Eyes,40064325,28264325,11800000,2021.csv,2021,0.7054736352103773,0.2945263647896227
2697,Northern Limit Line,40034677,337907,39696770,2015.csv,2015,0.008440357842777151,0.9915596421572228
2698,Dancer in the Dark,40031879,4184036,35847843,2000.csv,2000,0.10451760208407904,0.895482397915921
2699,Om Shanti Om,39990809,3597372,36393437,2007.csv,2007,0.0899549694030946,0.9100450305969054
2700,Dream House,39984400,21302340,18682060,2011.csv,2011,0.532766278848751,0.467233721151249
2701,Black Knight,39976235,33426971,6549264,2001.csv,2001,0.8361710651340728,0.16382893486592723
2702,Love O2O,39969537,0,39969537,2016.csv,2016,0.0,1.0
2703,Brotherhood of Blades 2,39966092,14204,39951888,2017.csv,2017,0.0003554012736596813,0.9996445987263404
2704,The Secret Life of Bees,39952437,37770162,2182275,2008.csv,2008,0.945378175554097,0.054621824445903015
2705,Astro Boy,39886986,19551067,20335919,2009.csv,2009,0.49016155294360925,0.5098384470563908
2706,Monte Carlo,39782683,23186769,16595914,2011.csv,2011,0.5828357277964384,0.41716427220356156
2707,Eiga Kaibutsukun,39766344,0,39766344,2011.csv,2011,0.0,1.0
2708,The Last Wish,39756292,0,39756292,2019.csv,2019,0.0,1.0
2709,Midnight Runners,39730433,0,39730433,2017.csv,2017,0.0,1.0
2710,Memento,39723096,25544867,14178229,2001.csv,2001,0.6430734150228371,0.3569265849771629
2711,Tokyo Revengers,39714073,0,39714073,2021.csv,2021,0.0,1.0
2712,The Forest,39712000,26594261,13117739,2016.csv,2016,0.6696782080983078,0.3303217919016922
2713,SP: The Motion Picture I,39674739,0,39674739,2010.csv,2010,0.0,1.0
2714,Detective Conan: The Raven Chaser,39664359,0,39664359,2009.csv,2009,0.0,1.0
2715,The November Man,39661919,25018119,14643800,2014.csv,2014,0.6307843803523475,0.3692156196476524
2716,Nightmare Alley,39629195,11338107,28291088,2021.csv,2021,0.2861049032159245,0.7138950967840755
2717,Intimate Strangers,39576060,0,39576060,2018.csv,2018,0.0,1.0
2718,Thugs of Hindostan,39570044,1449848,38120196,2018.csv,2018,0.0366400401273246,0.9633599598726754
2719,Recep Ivedik 4,39477906,0,39477906,2014.csv,2014,0.0,1.0
2720,Down with Love,39468111,20305251,19162860,2003.csv,2003,0.5144723293192319,0.4855276706807681
2721,The Legend of Bagger Vance,39459427,30919168,8540259,2000.csv,2000,0.7835686007300613,0.2164313992699387
2722,Nomadland,39458207,3700000,35758207,2021.csv,2021,0.09377009958916785,0.9062299004108322
2723,Agora,39457342,619423,38837919,2009.csv,2009,0.01569854857430589,0.9843014514256941
2724,Don Jon,39439355,24477704,14961651,2013.csv,2013,0.6206415901071405,0.37935840989285957
2725,Crocodile Dundee in Los Angeles,39438674,25635682,13802992,2001.csv,2001,0.6500137910316153,0.34998620896838467
2726,Halloween II,39421467,33392973,6028494,2009.csv,2009,0.8470758584402757,0.1529241415597243
2727,Sin City: A Dame to Kill For,39407616,13757804,25649812,2014.csv,2014,0.3491153588179503,0.6508846411820497
2728,King Richard,39359895,15129285,24230610,2021.csv,2021,0.3843832662663353,0.6156167337336647
2729,Uri: The Surgical Strike,39346577,4186168,35160409,2019.csv,2019,0.10639217739322025,0.8936078226067797
2730,Thank You for Smoking,39323027,24793509,14529518,2006.csv,2006,0.6305086584509376,0.3694913415490623
2731,Cirque du Freak: The Vampire's Assistant,39291383,13869515,25421868,2009.csv,2009,0.35299126528582614,0.6470087347141739
2732,Otoko-tachi no Yamato,39287114,0,39287114,2005.csv,2005,0.0,1.0
2733,The Gambler,39280992,33680992,5600000,2014.csv,2014,0.8574374089126874,0.14256259108731267
2734,Dumb and Dumberer: When Harry Met Lloyd,39267515,26276465,12991050,2003.csv,2003,0.6691654666713694,0.33083453332863055
2735,Mars Needs Moms,39233678,21392758,17840920,2011.csv,2011,0.5452651673391417,0.45473483266085835
2736,Scoop,39220946,10525717,28695229,2006.csv,2006,0.26836978893879815,0.7316302110612019
2737,Absolutely Fabulous: The Movie,39219109,4772155,34446954,2016.csv,2016,0.12167933238870877,0.8783206676112912
2738,Tazza: The High Rollers,39212715,0,39212715,2006.csv,2006,0.0,1.0
2739,My Mom Is a Character 2,39195565,0,39195565,2016.csv,2016,0.0,1.0
2740,Sink or Swim,39193850,0,39193850,2018.csv,2018,0.0,1.0
2741,Samba,39178695,151530,39027165,2014.csv,2014,0.0038676632797493638,0.9961323367202506
2742,The Spirit,39164441,19806188,19358253,2008.csv,2008,0.5057186441139297,0.49428135588607025
2743,Show Dogs,39156854,17857020,21299834,2018.csv,2018,0.4560381689499366,0.5439618310500635
2744,Women Who Flirt,39156132,375495,38780637,2014.csv,2014,0.009589685722787941,0.990410314277212
2745,Admiral,39143985,0,39143985,2008.csv,2008,0.0,1.0
2746,Masterpiece Mystery: Sherlock: The Abominable Bride,39139204,0,39139204,2016.csv,2016,0.0,1.0
2747,Ex-Files 2: The Backup Strikes Back,39108291,0,39108291,2015.csv,2015,0.0,1.0
2748,Haunted Castle,39093166,13651656,25441510,2001.csv,2001,0.3492082478047442,0.6507917521952559
2749,Believer,39047153,365639,38681514,2018.csv,2018,0.009364037372968011,0.990635962627032
2750,The Crown Jewels,39000000,0,39000000,2011.csv,2011,0.0,1.0
2751,The Life of David Gale,38955598,19955598,19000000,2003.csv,2003,0.512265220521066,0.48773477947893396
2752,Forbidden Empire 2014 Re-release,38885962,0,38885962,2014.csv,2014,0.0,1.0
2753,The Spy Gone North,38844509,500803,38343706,2018.csv,2018,0.012892504317663018,0.987107495682337
2754,First Sunday,38810311,37931869,878442,2008.csv,2008,0.9773657572597138,0.02263424274028621
2755,The Wicker Man,38805380,23649127,15156253,2006.csv,2006,0.6094290791637654,0.39057092083623457
2756,Criminal,38803993,14708696,24095297,2015.csv,2015,0.3790510940459143,0.6209489059540857
2757,Clockstoppers,38793283,36989956,1803327,2002.csv,2002,0.9535144524891075,0.046485547510892546
2758,Dreamer,38741732,32751093,5990639,2005.csv,2005,0.8453698714347618,0.15463012856523814
2759,Antoine and Sebastian,38719881,0,38719881,2013.csv,2013,0.0,1.0
2760,Someone Like You,38689940,27343067,11346873,2001.csv,2001,0.7067229103999645,0.29327708960003557
2761,Jeon Woochi,38681926,0,38681926,2009.csv,2009,0.0,1.0
2762,On the Basis of Sex,38673750,24622687,14051063,2018.csv,2018,0.6366769966708685,0.36332300332913153
2763,"Crouching Tiger, Hidden Dragon: Sword of Destiny",38659039,0,38659039,2016.csv,2016,0.0,1.0
2764,Basic Instinct 2,38629478,5971336,32658142,2006.csv,2006,0.15457977454419652,0.8454202254558034
2765,Accepted,38623262,36323505,2299757,2006.csv,2006,0.9404566864393794,0.05954331356062054
2766,Head of State,38620484,38125247,495237,2003.csv,2003,0.987176830823767,0.012823169176233006
2767,The Best of Me,38609668,26766213,11843455,2014.csv,2014,0.6932515710831805,0.30674842891681947
2768,Resident Evil: Welcome to Raccoon City,38600612,17000612,21600000,2021.csv,2021,0.44042337981584334,0.5595766201841567
2769,Taxi 5,38598227,0,38598227,2018.csv,2018,0.0,1.0
2770,Urban Legends: Final Cut,38574362,21468807,17105555,2000.csv,2000,0.5565563728571843,0.44344362714281577
2771,Always: Sunset on Third Street,38573583,0,38573583,2005.csv,2005,0.0,1.0
2772,Million Dollar Arm,38483455,36457627,2025828,2014.csv,2014,0.9473584687237672,0.05264153127623286
2773,What's the Worst That Could Happen?,38464131,32269834,6194297,2001.csv,2001,0.8389591331206728,0.16104086687932714
2774,Day Watch,38411815,0,38411815,2006.csv,2006,0.0,1.0
2775,Employee of the Month,38398532,28444855,9953677,2006.csv,2006,0.7407797516842571,0.2592202483157429
2776,Chernobyl Diaries,38390020,18119640,20270380,2012.csv,2012,0.4719882927906784,0.5280117072093216
2777,The Missing,38364277,27011180,11353097,2003.csv,2003,0.7040711336746943,0.2959288663253057
2778,Boruto: Naruto The Movie,38362448,919651,37442797,2015.csv,2015,0.023972688082887723,0.9760273119171122
2779,The Lazarus Effect,38356892,25801570,12555322,2015.csv,2015,0.6726710287162996,0.3273289712837005
2780,The Soloist,38332994,31720158,6612836,2009.csv,2009,0.8274897076914994,0.1725102923085006
2781,Ghajini,38316584,2430627,35885957,2008.csv,2008,0.0634353782685847,0.9365646217314153
2782,Van Wilder,38275483,21305259,16970224,2002.csv,2002,0.5566293964206801,0.44337060357931996
2783,Don't Be Afraid of the Dark,38269529,24046682,14222847,2011.csv,2011,0.6283506128335157,0.3716493871664843
2784,20th Century Boys 1: Beginning of the End,38231562,0,38231562,2008.csv,2008,0.0,1.0
2785,The Original Kings of Comedy,38182790,38182790,0,2000.csv,2000,1.0,0.0
2786,The Water Diviner,38176317,4196641,33979676,2014.csv,2014,0.10992786444014492,0.8900721355598551
2787,Encounter in the Third Dimension,38171557,7195792,30975765,1999.csv,1999,0.18851188071788635,0.8114881192821136
2788,Just My Luck,38159905,17326650,20833255,2006.csv,2006,0.45405380333100936,0.5459461966689907
2789,Jumping the Broom,38158601,37295394,863207,2011.csv,2011,0.9773784421499101,0.022621557850089943
2790,Happily N'Ever After,38085778,15589393,22496385,2007.csv,2007,0.40932321246004216,0.5906767875399578
2791,One for the Money,38080789,26414527,11666262,2011.csv,2011,0.6936444252770078,0.30635557472299224
2792,The Producers,38075318,19398532,18676786,2005.csv,2005,0.5094778722530958,0.4905221277469042
2793,The Banger Sisters,38068353,30307416,7760937,2002.csv,2002,0.7961315268879638,0.20386847311203612
2794,Arashi Anniversary Tour 5 x 20 Film: Record of Memories,38052695,0,38052695,2021.csv,2021,0.0,1.0
2795,But Always,38039248,430760,37608488,2014.csv,2014,0.011324093473141214,0.9886759065268588
2796,Overcomer,38026103,34746945,3279158,2019.csv,2019,0.9137656046426845,0.08623439535731547
2797,The Eagle,37989684,19490041,18499643,2011.csv,2011,0.5130350913158425,0.48696490868415754
2798,Kokkuri-san: Gekijô-ban,37982240,0,37982240,2010.csv,2010,0.0,1.0
2799,For Colored Girls,37981984,37729698,252286,2010.csv,2010,0.9933577456090761,0.0066422543909238655
2800,Helios,37938005,0,37938005,2015.csv,2015,0.0,1.0
2801,Killing Them Softly,37930465,15026056,22904409,2012.csv,2012,0.39614742397700636,0.6038525760229937
2802,Camping,37912041,0,37912041,2006.csv,2006,0.0,1.0
2803,The King,37886707,0,37886707,2017.csv,2017,0.0,1.0
2804,Hell or High Water,37879877,27007844,10872033,2016.csv,2016,0.7129865812394269,0.28701341876057307
2805,Amalfi: Rewards of the Goddess,37840539,0,37840539,2009.csv,2009,0.0,1.0
2806,Cold Eyes,37795598,0,37795598,2013.csv,2013,0.0,1.0
2807,Mission Milano,37749848,0,37749848,2016.csv,2016,0.0,1.0
2808,Bulletproof Monk,37713879,23358708,14355171,2003.csv,2003,0.6193663611213261,0.3806336388786738
2809,The Hills Have Eyes 2,37697773,20804166,16893607,2007.csv,2007,0.5518672416007173,0.4481327583992826
2810,The Handmaiden,37692886,2006788,35686098,2016.csv,2016,0.05324049742436809,0.9467595025756319
2811,Casanova,37691644,11304403,26387241,2005.csv,2005,0.2999180136584119,0.700081986341588
2812,The Yinyang Master,37690000,0,37690000,2021.csv,2021,0.0,1.0
2813,The Prince and Me,37666766,28176497,9490269,2004.csv,2004,0.7480466201956387,0.2519533798043612
2814,Halloween: Resurrection,37664855,30354442,7310413,2002.csv,2002,0.8059089036716058,0.1940910963283942
2815,Rurouni Kenshin Part I: Origins,37654579,0,37654579,2012.csv,2012,0.0,1.0
2816,The Covenant,37598767,23380495,14218272,2006.csv,2006,0.6218420673209842,0.37815793267901576
2817,Painted Skin,37579689,0,37579689,2008.csv,2008,0.0,1.0
2818,Pokémon the Movie: I Choose You!,37552144,2401722,35150422,2017.csv,2017,0.06395698738266449,0.9360430126173355
2819,Fat Buddies,37496410,0,37496410,2018.csv,2018,0.0,1.0
2820,Broken Embraces,37472507,5014305,32458202,2009.csv,2009,0.13381290448488006,0.86618709551512
2821,A Walk in the Woods,37461274,29504281,7956993,2015.csv,2015,0.7875941699153104,0.21240583008468958
2822,T-34,37410850,0,37410850,2019.csv,2019,0.0,1.0
2823,Sarileru Neekevvaru,37389889,821000,36568889,2020.csv,2020,0.021957807898279665,0.9780421921017204
2824,Pain and Glory,37359689,4567338,32792351,2019.csv,2019,0.12225310547954508,0.877746894520455
2825,Snowden,37357216,21587519,15769697,2016.csv,2016,0.5778674460109662,0.4221325539890339
2826,Natale in crociera,37350000,0,37350000,2007.csv,2007,0.0,1.0
2827,The Majestic,37317558,27807266,9510292,2001.csv,2001,0.7451523489291555,0.25484765107084445
2828,Becoming Jane,37311672,18670946,18640726,2007.csv,2007,0.5004049671105599,0.49959503288944007
2829,Home Again,37270721,27020284,10250437,2017.csv,2017,0.7249734718037786,0.27502652819622136
2830,Beauty Shop,37245453,36351350,894103,2005.csv,2005,0.9759943045933688,0.024005695406631247
2831,Pokémon: Lucario and the Mystery of Mew,37228626,0,37228626,2005.csv,2005,0.0,1.0
2832,"Like Father, Like Son",37170163,334616,36835547,2013.csv,2013,0.009002274216553745,0.9909977257834462
2833,The Family That Preys,37105289,37105289,0,2008.csv,2008,1.0,0.0
2834,A Witness Out of the Blue,37092694,0,37092694,2019.csv,2019,0.0,1.0
2835,Till The End Of The World,37013733,118660,36895073,2018.csv,2018,0.003205837141582018,0.9967941628584179
2836,Rurouni Kenshin: Final Chapter Part I - The Final,36964978,0,36964978,2021.csv,2021,0.0,1.0
2837,2.0,36945969,4152000,32793969,2018.csv,2018,0.11238032490093845,0.8876196750990616
2838,Devil's Due,36921560,15821461,21100099,2014.csv,2014,0.42851550692874296,0.571484493071257
2839,The Bachelor,36911617,21760240,15151377,1999.csv,1999,0.589522805245839,0.410477194754161
2840,Ex Machina,36869414,25442958,11426456,2015.csv,2015,0.6900830590906598,0.3099169409093402
2841,My Favorite Martian,36850101,36850101,0,1999.csv,1999,1.0,0.0
2842,The Adventurers,36796816,216556,36580260,2017.csv,2017,0.0058851831093211975,0.9941148168906788
2843,Titan A.E.,36754634,22753426,14001208,2000.csv,2000,0.6190627826684385,0.3809372173315615
2844,New Interpretation Records of the Three Kingdoms,36747486,0,36747486,2020.csv,2020,0.0,1.0
2845,The Adventures of Super Monkey,36745063,0,36745063,2007.csv,2007,0.0,1.0
2846,Negotiator: Mashita Masayoshi,36733286,0,36733286,2005.csv,2005,0.0,1.0
2847,Natale a Rio,36702844,0,36702844,2008.csv,2008,0.0,1.0
2848,Valentine,36684136,20384136,16300000,2001.csv,2001,0.5556662422143457,0.44433375778565426
2849,Sky of Love,36684020,0,36684020,2007.csv,2007,0.0,1.0
2850,Joy Ride,36642838,21974919,14667919,2001.csv,2001,0.5997057051094132,0.4002942948905868
2851,Return to Me,36609995,32722798,3887197,2000.csv,2000,0.8938214277275919,0.10617857227240812
2852,Burnt,36606743,13651946,22954797,2015.csv,2015,0.3729352813496683,0.6270647186503318
2853,The Intruder,36599361,35419122,1180239,2019.csv,2019,0.9677524697767265,0.03224753022327357
2854,The Priests,36577134,185093,36392041,2015.csv,2015,0.005060347265042691,0.9949396527349573
2855,The Tower,36512327,0,36512327,2012.csv,2012,0.0,1.0
2856,The Chaser,36467587,0,36467587,2008.csv,2008,0.0,1.0
2857,Baby Geniuses,36450736,27250736,9200000,1999.csv,1999,0.7476045476832073,0.2523954523167927
2858,Brooklyn's Finest,36440201,27163593,9276608,2009.csv,2009,0.7454292856397801,0.2545707143602199
2859,Detective Conan: The Lost Ship in the Sky,36407407,0,36407407,2010.csv,2010,0.0,1.0
2860,The Boat That Rocked,36348784,8017917,28330867,2009.csv,2009,0.22058281234387372,0.7794171876561262
2861,Detective Conan: Private Eye in the Distant Sea,36324232,0,36324232,2013.csv,2013,0.0,1.0
2862,Secret Reunion,36298578,0,36298578,2010.csv,2010,0.0,1.0
2863,Furry Vengeance,36288132,17630465,18657667,2010.csv,2010,0.48584658477322556,0.5141534152267744
2864,A Most Wanted Man,36233517,17237855,18995662,2014.csv,2014,0.4757433566275115,0.5242566433724886
2865,A Very Harold & Kumar Christmas,36192775,35061031,1131744,2011.csv,2011,0.9687301125708101,0.031269887429189944
2866,Nobunaga Concerto: The Movie,36187594,0,36187594,2016.csv,2016,0.0,1.0
2867,Dügün Dernek,36185741,0,36185741,2013.csv,2013,0.0,1.0
2868,The Confidence Man JP: Princess,36109913,0,36109913,2020.csv,2020,0.0,1.0
2869,The Door Lock,36100000,0,36100000,2021.csv,2021,0.0,1.0
2870,Sicko,36093504,24540079,11553425,2007.csv,2007,0.6799029265764831,0.3200970734235169
2871,Love Happens,36088028,22965110,13122918,2009.csv,2009,0.6363636716309353,0.3636363283690647
2872,Nothing to Lose,36075317,1016188,35059129,2018.csv,2018,0.028168512005036575,0.9718314879949634
2873,The Magic Hour,36023586,0,36023586,2008.csv,2008,0.0,1.0
2874,Whatever Works,36020534,5306706,30713828,2009.csv,2009,0.14732446776052793,0.8526755322394721
2875,Kundo: Age of the Rampant,35941291,280958,35660333,2014.csv,2014,0.00781713711953196,0.9921828628804681
2876,Ra.One,35911689,2511689,33400000,2011.csv,2011,0.06994070927713815,0.9300592907228619
2877,You Will Meet a Tall Dark Stranger,35867322,3248246,32619076,2010.csv,2010,0.09056282484652743,0.9094371751534726
2878,Doraemon the Movie: The New Records of Nobita's Spaceblazer 2014 Re-release,35861856,0,35861856,2014.csv,2014,0.0,1.0
2879,Garden State,35825316,26782316,9043000,2004.csv,2004,0.747580733132961,0.2524192668670389
2880,Conquest 1453,35797045,35730,35761315,2012.csv,2012,0.0009981270800425008,0.9990018729199575
2881,The New Adventures of Aladdin,35771820,0,35771820,2015.csv,2015,0.0,1.0
2882,Heidi,35755670,0,35755670,2015.csv,2015,0.0,1.0
2883,Riding in Cars with Boys,35743308,30165536,5577772,2001.csv,2001,0.8439491946296632,0.15605080537033675
2884,Hostel: Part II,35728183,17609452,18118731,2007.csv,2007,0.4928728673383698,0.5071271326616302
2885,"Tad, the Lost Explorer, and the Secret of King Midas",35704046,5874,35698172,2017.csv,2017,0.00016451916962016014,0.9998354808303799
2886,Hostiles,35669017,29819114,5849903,2017.csv,2017,0.835994835517895,0.164005164482105
2887,The Terror Live,35659824,0,35659824,2013.csv,2013,0.0,1.0
2888,Faster,35626958,23240020,12386938,2010.csv,2010,0.6523155864163311,0.34768441358366886
2889,Good Deeds,35579177,35025791,553386,2012.csv,2012,0.9844463518647438,0.015553648135256191
2890,My Dog Skip,35547761,34134641,1413120,2000.csv,2000,0.9602472853353549,0.039752714664645125
2891,The Queen's Corgi,35515687,0,35515687,2019.csv,2019,0.0,1.0
2892,Jersey Girl,35492921,25268157,10224764,2004.csv,2004,0.7119210334928477,0.28807896650715226
2893,Mia and the White Lion,35487190,399471,35087719,2018.csv,2018,0.011256766173934877,0.9887432338260651
2894,Arbitrage,35485056,7919574,27565482,2012.csv,2012,0.22318054112694652,0.7768194588730535
2895,Hide and Seek,35461505,0,35461505,2013.csv,2013,0.0,1.0
2896,Vacancy,35442935,19363565,16079370,2007.csv,2007,0.5463307426430684,0.45366925735693164
2897,Original Sin,35402320,16534221,18868099,2001.csv,2001,0.46703778170470184,0.5329622182952981
2898,Room,35401758,14677654,20724104,2015.csv,2015,0.4146024047732319,0.5853975952267682
2899,Namiya,35351623,70814,35280809,2017.csv,2017,0.0020031329254670996,0.997996867074533
2900,Death Note: L Change the World,35319632,0,35319632,2008.csv,2008,0.0,1.0
2901,The Darjeeling Limited,35307949,11902715,23405234,2007.csv,2007,0.337111481609991,0.662888518390009
2902,Assault on Precinct 13,35294470,20040895,15253575,2005.csv,2005,0.5678196896000989,0.4321803103999012
2903,Eye in the Sky,35259653,18704595,16555058,2016.csv,2016,0.5304815393390286,0.46951846066097136
2904,Edtv,35242897,22431897,12811000,1999.csv,1999,0.636494128164322,0.363505871835678
2905,Les Tuche 2: The American Dream,35210425,0,35210425,2016.csv,2016,0.0,1.0
2906,Courageous,35185884,34522221,663663,2011.csv,2011,0.9811383735591239,0.01886162644087612
2907,Destiny: The Tale of Kamakura,35166640,0,35166640,2017.csv,2017,0.0,1.0
2908,The Girl in the Spider's Web,35164920,14841338,20323582,2018.csv,2018,0.42204953118050603,0.577950468819494
2909,The Adventures of Rocky & Bullwinkle,35134820,26005820,9129000,2000.csv,2000,0.7401722849298786,0.2598277150701213
2910,The Secret in Their Eyes,35079650,6391436,28688214,2009.csv,2009,0.18219782694525175,0.8178021730547482
2911,Miss Potter,35078241,3005605,32072636,2006.csv,2006,0.08568288814709951,0.9143171118529005
2912,Alfie,35060882,13399812,21661070,2004.csv,2004,0.3821869626668262,0.6178130373331737
2913,My Week with Marilyn,35057696,14600347,20457349,2011.csv,2011,0.4164662446727817,0.5835337553272183
2914,The Liquidator,35046130,0,35046130,2017.csv,2017,0.0,1.0
2915,Flight of the Phoenix,35021497,21009180,14012317,2004.csv,2004,0.5998938309233326,0.4001061690766674
2916,Welcome to the North,34995189,0,34995189,2012.csv,2012,0.0,1.0
2917,I Fell in Love Like a Flower Bouquet,34975905,0,34975905,2021.csv,2021,0.0,1.0
2918,Bambi 2: The Great Prince of the Forest,34958637,0,34958637,2006.csv,2006,0.0,1.0
2919,Blind Detective,34958596,0,34958596,2013.csv,2013,0.0,1.0
2920,When Marnie Was There,34949567,561085,34388482,2014.csv,2014,0.016054133088401354,0.9839458669115987
2921,The Sitter,34942188,30441326,4500862,2011.csv,2011,0.8711911801287315,0.12880881987126852
2922,The Hate U Give,34934009,29719483,5214526,2018.csv,2018,0.8507321046376326,0.14926789536236737
2923,Lost and Love,34930177,188817,34741360,2015.csv,2015,0.005405555202311171,0.9945944447976889
2924,Malignant,34892041,13391791,21500250,2021.csv,2021,0.3838064674978457,0.6161935325021543
2925,Gomorrah,34861529,1579146,33282383,2008.csv,2008,0.045297668957663906,0.9547023310423361
2926,Secret in Their Eyes,34854990,20180155,14674835,2015.csv,2015,0.578974631752871,0.42102536824712905
2927,"Dad, Where Are We Going 2",34840000,0,34840000,2015.csv,2015,0.0,1.0
2928,Chimpanzee,34823764,28972764,5851000,2012.csv,2012,0.8319825507661952,0.16801744923380482
2929,Disaster Movie,34816824,14190901,20625923,2008.csv,2008,0.40758746403750096,0.5924125359624991
2930,Kidnap,34814102,30971040,3843062,2017.csv,2017,0.8896119164584513,0.11038808354154876
2931,Doraemon: Nobita and the Space Heroes,34811747,0,34811747,2015.csv,2015,0.0,1.0
2932,The Life Aquatic with Steve Zissou,34808403,24020403,10788000,2004.csv,2004,0.6900748362399735,0.30992516376002655
2933,Sunshine,34806360,3675753,31130607,2007.csv,2007,0.10560578583913974,0.8943942141608603
2934,Assembly,34786960,0,34786960,2007.csv,2007,0.0,1.0
2935,Broken City,34737199,19701164,15036035,2013.csv,2013,0.5671488941868917,0.4328511058131083
2936,Endless Love,34718173,23438250,11279923,2014.csv,2014,0.6751003285800782,0.32489967141992177
2937,Jane Eyre,34710627,11242660,23467967,2011.csv,2011,0.3238967708650149,0.6761032291349851
2938,The Kids Are All Right,34705850,20811365,13894485,2010.csv,2010,0.5996500589958177,0.4003499410041823
2939,Doraemon The Movie: Nobita's Great Battle of the Mermaid King,34702573,0,34702573,2010.csv,2010,0.0,1.0
2940,October Sky,34698685,32570685,2128000,1999.csv,1999,0.9386720274846151,0.06132797251538495
2941,Nana,34671042,0,34671042,2005.csv,2005,0.0,1.0
2942,The Man Standing Next,34664900,113527,34551373,2020.csv,2020,0.003274984205925879,0.9967250157940741
2943,Malibu's Most Wanted,34622504,34432201,190303,2003.csv,2003,0.9945034882514563,0.005496511748543664
2944,Alex Cross,34618867,25888412,8730455,2012.csv,2012,0.7478122262060165,0.2521877737939835
2945,Gone Baby Gone,34612443,20292962,14319481,2007.csv,2007,0.5862909474491587,0.41370905255084134
2946,The Extraordinary Adventures of Adèle Blanc-Sec,34604339,0,34604339,2010.csv,2010,0.0,1.0
2947,R.A.I.D. Special Unit,34598750,0,34598750,2017.csv,2017,0.0,1.0
2948,The Best Man,34573780,34102780,471000,1999.csv,1999,0.9863769596497692,0.013623040350230724
2949,Crank: High Voltage,34572541,13684249,20888292,2009.csv,2009,0.3958126479624393,0.6041873520375607
2950,Salmon Fishing in the Yemen,34564651,9047981,25516670,2012.csv,2012,0.2617697774526929,0.7382302225473071
2951,Haywire,34513760,18942396,15571364,2012.csv,2012,0.548836058430029,0.4511639415699709
2952,Steve Jobs,34441873,17766658,16675215,2015.csv,2015,0.515844710303647,0.484155289696353
2953,Adventures in Zambezia,34428345,0,34428345,2012.csv,2012,0.0,1.0
2954,Swimfan,34411240,28564995,5846245,2002.csv,2002,0.8301065291457094,0.16989347085429063
2955,My Mom is a Character 3,34360029,0,34360029,2020.csv,2020,0.0,1.0
2956,Pokémon the Movie: Destiny Deoxys,34337258,0,34337258,2004.csv,2004,0.0,1.0
2957,Warrior of the Hornor,34291831,0,34291831,2019.csv,2019,0.0,1.0
2958,The Medallion,34268701,22219192,12049509,2003.csv,2003,0.648381507078427,0.35161849292157293
2959,American Psycho,34266564,15070285,19196279,2000.csv,2000,0.43979562701413544,0.5602043729858646
2960,Wild Safari - A South African Adventure,34257135,16621530,17635605,2005.csv,2005,0.48519906874874386,0.5148009312512561
2961,Bad News Bears,34252847,32868349,1384498,2005.csv,2005,0.95958006060051,0.040419939399489915
2962,Victor Frankenstein,34227298,5775076,28452222,2015.csv,2015,0.16872719546836562,0.8312728045316343
2963,The House,34184504,25584504,8600000,2017.csv,2017,0.748424022767743,0.25157597723225705
2964,Cirque du Soleil: Worlds Away,34153101,12512862,21640239,2012.csv,2012,0.36637557450493297,0.633624425495067
2965,The Battle: Roar to Victory,34148707,0,34148707,2019.csv,2019,0.0,1.0
2966,Black & White: The Dawn of Justice,34146896,0,34146896,2014.csv,2014,0.0,1.0
2967,Gokusen: The Movie,34117482,0,34117482,2009.csv,2009,0.0,1.0
2968,Instinct,34105207,34105207,0,1999.csv,1999,1.0,0.0
2969,In Bruges,34085749,7800824,26284925,2008.csv,2008,0.22885881134664227,0.7711411886533578
2970,The Bad Guys: The Movie,34024386,166972,33857414,2019.csv,2019,0.004907421400638942,0.9950925785993611
2971,"My Love, Don't Cross That River",34012261,0,34012261,2014.csv,2014,0.0,1.0
2972,The Bob's Burgers Movie,34004357,31789437,2214920,2022.csv,2022,0.9348636411504561,0.0651363588495439
2973,Darkness,33988736,22163442,11825294,2002.csv,2002,0.6520819720980504,0.34791802790194964
2974,Dungeons & Dragons,33978694,15391970,18586724,2000.csv,2000,0.45298886413939277,0.5470111358606072
2975,The Fighting Temptations,33972062,30250745,3721317,2003.csv,2003,0.8904594899185101,0.1095405100814899
2976,The Witness,33963557,418063,33545494,2015.csv,2015,0.012309164202088727,0.9876908357979113
2977,Doraemon the Movie: Nobita's New Dinosaur,33942341,0,33942341,2020.csv,2020,0.0,1.0
2978,Hotel Rwanda,33882243,23530892,10351351,2004.csv,2004,0.6944903854210597,0.3055096145789404
2979,Camping 2,33857735,0,33857735,2010.csv,2010,0.0,1.0
2980,The Good Liar,33856058,17156058,16700000,2019.csv,2019,0.5067352495674482,0.49326475043255186
2981,Don't Go Breaking My Heart 2,33801759,0,33801759,2014.csv,2014,0.0,1.0
2982,Jay and Silent Bob Strike Back,33788161,30085147,3703014,2001.csv,2001,0.890404985343831,0.10959501465616907
2983,The Art of Racing in the Rain,33766787,26395642,7371145,2019.csv,2019,0.7817042823766442,0.21829571762335576
2984,Love and Honor,33755574,60910,33694664,2006.csv,2006,0.0018044427269996949,0.9981955572730004
2985,I Want to Eat Your Pancreas,33748006,277019,33470987,2017.csv,2017,0.008208455338072419,0.9917915446619275
2986,Deliver Us from Evil,33718703,0,33718703,2020.csv,2020,0.0,1.0
2987,Nobody's Fool,33705333,31713110,1992223,2018.csv,2018,0.9408929441521909,0.05910705584780901
2988,Mr. Woodcock,33683200,25799486,7883714,2007.csv,2007,0.7659452189815694,0.23405478101843055
2989,The Skin I Live In,33678406,3185812,30492594,2011.csv,2011,0.09459509455405936,0.9054049054459407
2990,Three Heroes on Distant Shores,33674759,0,33674759,2012.csv,2012,0.0,1.0
2991,Gantz: Perfect Answer,33672515,0,33672515,2011.csv,2011,0.0,1.0
2992,Y tu mamá también,33616692,13839658,19777034,2001.csv,2001,0.411690061592021,0.588309938407979
2993,Because of Winn-Dixie,33589427,32647042,942385,2005.csv,2005,0.9719439989256143,0.0280560010743857
2994,Punch,33556725,0,33556725,2011.csv,2011,0.0,1.0
2995,Nick and Norah's Infinite Playlist,33556631,31487293,2069338,2008.csv,2008,0.938332963163078,0.06166703683692204
2996,Bloodshot,33542457,12561824,20980633,2020.csv,2020,0.37450518308781017,0.6254948169121898
2997,Friday After Next,33526835,33253609,273226,2002.csv,2002,0.9918505280919001,0.008149471908099885
2998,Arthur 3: The War of the Two Worlds,33519334,0,33519334,2010.csv,2010,0.0,1.0
2999,Run Fatboy Run,33478921,6003262,27475659,2007.csv,2007,0.17931467982495614,0.8206853201750439
3000,Fireproof,33473297,33456317,16980,2008.csv,2008,0.9994927299811548,0.0005072700188451709
3001,Red Planet,33463969,17480890,15983079,2000.csv,2000,0.5223794583362182,0.4776205416637817
3002,Mystery Men,33461011,29762011,3699000,1999.csv,1999,0.8894534298440654,0.11054657015593462
3003,2016: Obama's America,33449086,33449086,0,2012.csv,2012,1.0,0.0
3004,Get on Up,33448971,30703100,2745871,2014.csv,2014,0.9179086555457865,0.08209134445421355
3005,Wonder Boys,33426588,19393557,14033031,2000.csv,2000,0.5801835652505125,0.41981643474948743
3006,Tell No One,33406992,6177192,27229800,2006.csv,2006,0.1849071595551015,0.8150928404448985
3007,Pokémon: Jirachi - Wish Maker,33393751,0,33393751,2003.csv,2003,0.0,1.0
3008,The Perks of Being a Wallflower,33384127,17742948,15641179,2012.csv,2012,0.5314785676438386,0.46852143235616134
3009,The Box,33333531,15051977,18281554,2009.csv,2009,0.45155663226917064,0.5484433677308294
3010,Girls,33325338,0,33325338,2014.csv,2014,0.0,1.0
3011,The Cave,33296457,15007991,18288466,2005.csv,2005,0.450738377359489,0.5492616226405109
3012,Marathon,33284089,0,33284089,2005.csv,2005,0.0,1.0
3013,Che: Part One,33266274,0,33266274,2008.csv,2008,0.0,1.0
3014,Perfect Strangers,33262366,1014507,32247859,2017.csv,2017,0.03050014541960124,0.9694998545803988
3015,Confessions of a Teenage Drama Queen,33251890,29331068,3920822,2004.csv,2004,0.8820872437626853,0.11791275623731463
3016,Project Almanac,33213241,22348241,10865000,2015.csv,2015,0.6728714310054836,0.32712856899451637
3017,Bharat,33185983,2971549,30214434,2019.csv,2019,0.08954229259986062,0.9104577074001394
3018,Baaghi 2,33139063,1319579,31819484,2018.csv,2018,0.039819442088631175,0.9601805579113688
3019,The Crocodile Hunter: Collision Course,33082548,28442574,4639974,2002.csv,2002,0.8597455673607728,0.14025443263922718
3020,Girl with a Pearl Earring,33030115,11670971,21359144,2003.csv,2003,0.3533433353168767,0.6466566646831232
3021,The Brice Man,33026616,0,33026616,2005.csv,2005,0.0,1.0
3022,Dogwood Tree,33016351,0,33016351,2010.csv,2010,0.0,1.0
3023,Confessions of a Dangerous Mind,33013805,16007718,17006087,2002.csv,2002,0.4848795223695057,0.5151204776304943
3024,Lockout,32948113,14326864,18621249,2012.csv,2012,0.43483109336185655,0.5651689066381435
3025,Inside Llewyn Davis,32935319,13235319,19700000,2013.csv,2013,0.40185792644060925,0.5981420735593908
3026,Sleepless,32917353,20783704,12133649,2017.csv,2017,0.6313905009312262,0.3686094990687738
3027,Brightburn,32893421,17300439,15592982,2019.csv,2019,0.5259543846169117,0.4740456153830883
3028,7 Dwarves: The Forest Is Not Enough,32863752,0,32863752,2006.csv,2006,0.0,1.0
3029,Serial Teachers,32849727,0,32849727,2013.csv,2013,0.0,1.0
3030,Hindi Medium,32841493,0,32841493,2017.csv,2017,0.0,1.0
3031,Bait,32813407,0,32813407,2012.csv,2012,0.0,1.0
3032,The Crossing,32806475,0,32806475,2014.csv,2014,0.0,1.0
3033,Fly Me to the Saitama,32802347,0,32802347,2019.csv,2019,0.0,1.0
3034,Adaptation.,32801173,22498520,10302653,2002.csv,2002,0.6859059583021619,0.31409404169783806
3035,Old Boys: The Way of the Dragon,32800000,0,32800000,2014.csv,2014,0.0,1.0
3036,Big Red Envelope,32800000,0,32800000,2021.csv,2021,0.0,1.0
3037,Doraemon the Movie: Nobita's New Great Adventure into the Underworld,32787846,0,32787846,2007.csv,2007,0.0,1.0
3038,Steel Rain,32783733,0,32783733,2017.csv,2017,0.0,1.0
3039,LOL (Laughing Out Loud),32764784,0,32764784,2009.csv,2009,0.0,1.0
3040,Awake,32730062,14377198,18352864,2007.csv,2007,0.439265834571288,0.560734165428712
3041,Part of Me,32726956,25326071,7400885,2012.csv,2012,0.7738596586862524,0.2261403413137476
3042,Leap Year,32686500,25918920,6767580,2010.csv,2010,0.7929548896333348,0.20704511036666515
3043,Mud,32613173,21590086,11023087,2013.csv,2013,0.6620050738393348,0.3379949261606652
3044,BTS Permission to Dance on Stage - Seoul: Live Viewing,32600000,6840000,25760000,2022.csv,2022,0.2098159509202454,0.7901840490797546
3045,88 Minutes,32593385,17213467,15379918,2007.csv,2007,0.5281276246698525,0.47187237533014753
3046,Cry Wolf,32586408,10047674,22538734,2005.csv,2005,0.30833941562383926,0.6916605843761607
3047,Last Chance Harvey,32566966,14889042,17677924,2008.csv,2008,0.4571823485184343,0.5428176514815657
3048,The Musketeer,32533802,27073640,5460162,2001.csv,2001,0.832169569360507,0.16783043063949304
3049,The Hurricane Heist,32517248,6115825,26401423,2018.csv,2018,0.18807941557661953,0.8119205844233804
3050,Midsummer's Equation,32514549,0,32514549,2013.csv,2013,0.0,1.0
3051,REC,32511655,0,32511655,2007.csv,2007,0.0,1.0
3052,Fighting,32482728,23091010,9391718,2009.csv,2009,0.7108704047270906,0.2891295952729093
3053,Nameless Gangster: Rules of the Time,32472645,0,32472645,2012.csv,2012,0.0,1.0
3054,UglyDolls,32450241,20150241,12300000,2019.csv,2019,0.6209581309426947,0.3790418690573053
3055,Movie 43,32438988,8840453,23598535,2012.csv,2012,0.2725255485775327,0.7274744514224674
3056,The House That Never Dies II,32433588,0,32433588,2017.csv,2017,0.0,1.0
3057,The Invention of Lying,32406507,18451251,13955256,2009.csv,2009,0.5693687073401648,0.43063129265983524
3058,Night Watch,32396890,0,32396890,2004.csv,2004,0.0,1.0
3059,Dhoom 2,32396427,2643586,29752841,2006.csv,2006,0.08160115928833757,0.9183988407116624
3060,Stuber,32390945,22370452,10020493,2019.csv,2019,0.6906390659488323,0.3093609340511677
3061,Detective K: Secret of Virtuous Widow,32358664,0,32358664,2011.csv,2011,0.0,1.0
3062,Alpha Dog,32351125,15309602,17041523,2007.csv,2007,0.47323244554864785,0.5267675544513521
3063,The Wave,32350637,0,32350637,2008.csv,2008,0.0,1.0
3064,Hit Me Anyone One More Time!,32333512,0,32333512,2019.csv,2019,0.0,1.0
3065,Kevin Hart: Let Me Explain,32318051,32244051,74000,2013.csv,2013,0.997710257960791,0.002289742039208986
3066,Potiche,32309881,1618844,30691037,2010.csv,2010,0.050103681904616115,0.9498963180953839
3067,Pokémon,32293377,0,32293377,2013.csv,2013,0.0,1.0
3068,Licorice Pizza,32288370,17318007,14970363,2021.csv,2021,0.5363543281992866,0.46364567180071337
3069,Masquerade Night,32287400,0,32287400,2021.csv,2021,0.0,1.0
3070,Hart's War,32287044,19077641,13209403,2002.csv,2002,0.5908760492289106,0.4091239507710895
3071,Seven Psychopaths,32226382,15024049,17202333,2012.csv,2012,0.4662034044032619,0.5337965955967381
3072,Somewhere Winter,32218990,0,32218990,2019.csv,2019,0.0,1.0
3073,Once Upon a Time in Hong Kong,32218874,0,32218874,2021.csv,2021,0.0,1.0
3074,Home Sweet Home,32178677,0,32178677,2021.csv,2021,0.0,1.0
3075,Reindeer Games,32168970,23368995,8799975,2000.csv,2000,0.7264452358903627,0.2735547641096373
3076,The After-Dinner Mysteries,32160741,0,32160741,2013.csv,2013,0.0,1.0
3077,The Kid Who Would Be King,32140970,16790790,15350180,2019.csv,2019,0.5224108046521309,0.4775891953478691
3078,Respect,32121125,24278399,7842726,2021.csv,2021,0.7558390000350237,0.2441609999649763
3079,Amazing Grace,32120360,21250683,10869677,2007.csv,2007,0.6615954179841073,0.33840458201589274
3080,April Bride,32112343,0,32112343,2009.csv,2009,0.0,1.0
3081,The Suspect: Muroi Shinji,32104229,0,32104229,2005.csv,2005,0.0,1.0
3082,You Again,32054369,25702053,6352316,2010.csv,2010,0.8018268274131367,0.1981731725868633
3083,Two Tigers,32001580,0,32001580,2019.csv,2019,0.0,1.0
3084,Os Dez Mandamentos - O Filme,31998251,0,31998251,2016.csv,2016,0.0,1.0
3085,Dilwale,31994323,4871263,27123060,2015.csv,2015,0.15225397955756087,0.8477460204424391
3086,Stick It,31976848,26910736,5066112,2006.csv,2006,0.8415693754431331,0.1584306245568669
3087,Suffragette,31972096,4702420,27269676,2015.csv,2015,0.1470788777814254,0.8529211222185746
3088,The Floating Castle,31967471,0,31967471,2012.csv,2012,0.0,1.0
3089,The Neighbors,31949315,0,31949315,2012.csv,2012,0.0,1.0
3090,Hunting and Gathering,31920899,0,31920899,2007.csv,2007,0.0,1.0
3091,All About Me,31920159,0,31920159,2018.csv,2018,0.0,1.0
3092,Bounty Hunters,31918573,0,31918573,2016.csv,2016,0.0,1.0
3093,Bad Times at the El Royale,31882724,17839115,14043609,2018.csv,2018,0.5595229253309724,0.44047707466902764
3094,The Seeker: The Dark Is Rising,31852619,8794452,23058167,2007.csv,2007,0.2760982385781213,0.7239017614218787
3095,Tinker Bell and the Legend of the NeverBeast,31836701,0,31836701,2014.csv,2014,0.0,1.0
3096,Marrying the Mafia 2: Enemy-in-Law,31835989,0,31835989,2005.csv,2005,0.0,1.0
3097,The Dream Team,31822402,0,31822402,2012.csv,2012,0.0,1.0
3098,Self/less,31807156,12279691,19527465,2015.csv,2015,0.38606692783221486,0.6139330721677851
3099,Blood Work,31794718,26235081,5559637,2002.csv,2002,0.825139603376888,0.17486039662311206
3100,Welcome to Dongmakgol,31787130,0,31787130,2005.csv,2005,0.0,1.0
3101,Underdogs,31775719,0,31775719,2013.csv,2013,0.0,1.0
3102,Spring Breakers,31724284,14124284,17600000,2013.csv,2013,0.44521994570468476,0.5547800542953152
3103,Beautiful Boy,31711319,7649973,24061346,2018.csv,2018,0.24123793147803155,0.7587620685219685
3104,Doraemon the Movie: Nobita and the Green Giant Legend,31684949,0,31684949,2008.csv,2008,0.0,1.0
3105,Suddenly Paradise,31679869,0,31679869,2003.csv,2003,0.0,1.0
3106,Hunter Killer,31672678,15767460,15905218,2018.csv,2018,0.49782528651350544,0.5021747134864946
3107,Rent,31670620,29077547,2593073,2005.csv,2005,0.918123705819463,0.08187629418053705
3108,New World,31670607,457806,31212801,2013.csv,2013,0.014455232891494628,0.9855447671085054
3109,Ae Dil Hai Mushkil,31668920,4264983,27403937,2016.csv,2016,0.1346740905594507,0.8653259094405493
3110,Anna,31626978,7743794,23883184,2019.csv,2019,0.2448477372703772,0.7551522627296228
3111,Super Troopers 2,31626386,30617396,1008990,2018.csv,2018,0.9680965760678442,0.03190342393215589
3112,Daddy's Little Girls,31609243,31366978,242265,2007.csv,2007,0.9923356279047872,0.007664372095212783
3113,Double Take,31603059,29831583,1771476,2001.csv,2001,0.9439460591457302,0.05605394085426983
3114,Love in the Time of Cholera,31575877,4607608,26968269,2007.csv,2007,0.14592177439758838,0.8540782256024116
3115,Jennifer's Body,31556061,16204793,15351268,2009.csv,2009,0.5135239471111429,0.4864760528888571
3116,The Four 3,31521335,0,31521335,2014.csv,2014,0.0,1.0
3117,Bodyguard,31516209,1834384,29681825,2011.csv,2011,0.058204462345074565,0.9417955376549254
3118,The New World 2005 Re-release,31510855,12712093,18798762,2005.csv,2005,0.4034194883001429,0.596580511699857
3119,The Thing,31505287,16928670,14576617,2011.csv,2011,0.5373279094394537,0.46267209056054626
3120,Harry Potter and the Sorcerer's Stone 2020 Re-release,31501815,0,31501815,2020.csv,2020,0.0,1.0
3121,Dance Flick,31439140,25662155,5776985,2009.csv,2009,0.8162486314829223,0.18375136851707777
3122,A Serious Man,31430334,9228768,22201566,2009.csv,2009,0.2936261510933991,0.7063738489066008
3123,I Don't Know How She Does It,31410151,9662284,21747867,2011.csv,2011,0.3076166045811114,0.6923833954188886
3124,Lost Souls,31355910,16815253,14540657,2000.csv,2000,0.5362706105483783,0.46372938945162173
3125,Assassination Classroom: The Graduation,31352921,0,31352921,2016.csv,2016,0.0,1.0
3126,"All's Well, Ends Well 2011",31335572,0,31335572,2011.csv,2011,0.0,1.0
3127,Johnson Family Vacation,31326183,31203964,122219,2004.csv,2004,0.9960985032871703,0.003901496712829648
3128,What's in a Name?,31303580,8111,31295469,2012.csv,2012,0.00025910774422605975,0.9997408922557739
3129,101 Proposals,31283838,0,31283838,2013.csv,2013,0.0,1.0
3130,How High,31283740,31178740,105000,2001.csv,2001,0.9966436238122424,0.003356376187757602
3131,Tazza: The Hidden Card,31278476,251555,31026921,2014.csv,2014,0.008042431479078457,0.9919575685209215
3132,Deutschland. Ein Sommermärchen,31257991,0,31257991,2006.csv,2006,0.0,1.0
3133,Perfect Strangers,31254929,0,31254929,2016.csv,2016,0.0,1.0
3134,Saving Mr. Wu,31222161,92696,31129465,2015.csv,2015,0.0029689168536412326,0.9970310831463588
3135,Honest Thief,31220247,14163574,17056673,2020.csv,2020,0.4536663018713465,0.5463336981286535
3136,Welcome,31203567,0,31203567,2007.csv,2007,0.0,1.0
3137,Pride and Glory,31200557,15740721,15459836,2008.csv,2008,0.5045012818200649,0.49549871817993507
3138,The Stepfather,31198531,29062561,2135970,2009.csv,2009,0.9315361995729863,0.0684638004270137
3139,The Invisible Guest,31191910,0,31191910,2017.csv,2017,0.0,1.0
3140,My Dear Liar,31177968,90545,31087423,2019.csv,2019,0.0029041340987969455,0.997095865901203
3141,The Blind Swordsman: Zatoichi,31167430,0,31167430,2003.csv,2003,0.0,1.0
3142,The New Guy,31167388,29760152,1407236,2002.csv,2002,0.9548490877708457,0.0451509122291544
3143,Joyful Noise,31158113,30932113,226000,2012.csv,2012,0.9927466724316714,0.007253327568328673
3144,Dogma,31117471,30652890,464581,1999.csv,1999,0.9850700913322937,0.014929908667706318
3145,Mrs. Brown's Boys D'Movie,31116264,0,31116264,2014.csv,2014,0.0,1.0
3146,Train Man,31090100,0,31090100,2005.csv,2005,0.0,1.0
3147,Premium Rush,31083599,20275446,10808153,2012.csv,2012,0.6522875938529512,0.3477124061470488
3148,Ultraviolet,31070211,18535812,12534399,2006.csv,2006,0.5965782466041186,0.4034217533958813
3149,The Wild Goose Lake,31064835,12573,31052262,2019.csv,2019,0.0004047341632427792,0.9995952658367572
3150,The Strangers: Prey at Night,31039126,24586708,6452418,2018.csv,2018,0.7921198554366512,0.20788014456334886
3151,Beauty and the Beast 2000 IMAX Release,31033346,25487190,5546156,2001.csv,2001,0.8212839827197492,0.17871601728025074
3152,Vysotsky. Thank You for Being Alive,31016553,0,31016553,2011.csv,2011,0.0,1.0
3153,This Is Not What I Expected,30996615,337670,30658945,2017.csv,2017,0.010893770174581966,0.9891062298254181
3154,Silenced,30996130,0,30996130,2011.csv,2011,0.0,1.0
3155,Joe Dirt,30987695,27087695,3900000,2001.csv,2001,0.8741435915126956,0.1258564084873044
3156,Pathfinder,30984583,10232081,20752502,2007.csv,2007,0.3302313605446941,0.6697686394553058
3157,Doraemon the Movie: Nobita's Dinosaur,30963292,0,30963292,2006.csv,2006,0.0,1.0
3158,Playing for Keeps,30962335,13103272,17859063,2012.csv,2012,0.42320038201253235,0.5767996179874677
3159,Rise of the Legend,30932534,0,30932534,2014.csv,2014,0.0,1.0
3160,Billy Lynn's Long Halftime Walk,30930984,1738477,29192507,2016.csv,2016,0.05620503376161586,0.9437949662383841
3161,The Promise,30925693,669625,30256068,2005.csv,2005,0.021652707992671338,0.9783472920073286
3162,Hearts in Atlantis,30919415,24185781,6733634,2001.csv,2001,0.7822198770578292,0.2177801229421708
3163,Pandora,30896701,0,30896701,2016.csv,2016,0.0,1.0
3164,Gintama 2: Rules are Made to be Broken,30896653,0,30896653,2018.csv,2018,0.0,1.0
3165,Igor,30893885,19528602,11365283,2008.csv,2008,0.632118686270762,0.367881313729238
3166,The Little Things,30863426,15342746,15520680,2021.csv,2021,0.4971173971418468,0.5028826028581532
3167,African Cats,30857747,15428747,15429000,2011.csv,2011,0.499995900543225,0.500004099456775
3168,The Unholy,30832137,15532137,15300000,2021.csv,2021,0.5037645298475418,0.4962354701524581
3169,Shin Ultraman,30810782,0,30810782,2022.csv,2022,0.0,1.0
3170,Attack on Titan Part 1,30810658,449523,30361135,2015.csv,2015,0.014589853939503662,0.9854101460604964
3171,Winter's Tale,30800231,12600231,18200000,2014.csv,2014,0.40909534087585253,0.5909046591241475
3172,Monsoon Wedding,30787356,13885966,16901390,2001.csv,2001,0.45102820781362324,0.5489717921863768
3173,Wolf Creek,30762648,16188180,14574468,2005.csv,2005,0.5262284313105946,0.4737715686894054
3174,Norm of the North,30734502,17062499,13672003,2016.csv,2016,0.5551578157993254,0.44484218420067456
3175,Carnage,30722632,2547047,28175585,2011.csv,2011,0.08290458317503527,0.9170954168249648
3176,A Man Called Ove,30692889,3479315,27213574,2015.csv,2015,0.11335899334858963,0.8866410066514103
3177,Nancy Drew,30666930,25612520,5054410,2007.csv,2007,0.8351836978791161,0.16481630212088397
3178,A Wedding Invitation,30665036,14350,30650686,2013.csv,2013,0.0004679596658552757,0.9995320403341448
3179,Death Proof,30663961,0,30663961,2007.csv,2007,0.0,1.0
3180,When the Bough Breaks,30658387,29747603,910784,2016.csv,2016,0.9702925010373181,0.02970749896268189
3181,Virus,30652005,14036005,16616000,1999.csv,1999,0.4579147432606774,0.5420852567393226
3182,Wild Tales,30642704,3106530,27536174,2014.csv,2014,0.10137910805782675,0.8986208919421732
3183,City of God,30641770,7564459,23077311,2002.csv,2002,0.2468675601964247,0.7531324398035754
3184,Superstar,30636478,30636478,0,1999.csv,1999,1.0,0.0
3185,Twosabu ilchae,30622421,0,30622421,2006.csv,2006,0.0,1.0
3186,The Last Warrior,30618274,0,30618274,2017.csv,2017,0.0,1.0
3187,Be Kind Rewind,30579406,11175164,19404242,2008.csv,2008,0.36544738638808094,0.6345526136119191
3188,Cabin Fever,30553394,21158188,9395206,2003.csv,2003,0.6924987777135332,0.30750122228646676
3189,The Last Duel,30552111,10853945,19698166,2021.csv,2021,0.35526006697213164,0.6447399330278684
3190,Two for the Money,30526509,22991379,7535130,2005.csv,2005,0.7531610968027821,0.24683890319721788
3191,The Best Movie,30525503,0,30525503,2008.csv,2008,0.0,1.0
3192,A Dangerous Method,30519436,5704709,24814727,2011.csv,2011,0.18692052500577008,0.81307947499423
3193,The Four,30505808,0,30505808,2012.csv,2012,0.0,1.0
3194,Mesrine: Killer Instinct,30503743,0,30503743,2008.csv,2008,0.0,1.0
3195,Natale a New York,30437121,0,30437121,2006.csv,2006,0.0,1.0
3196,What's Your Number?,30426096,14011084,16415012,2011.csv,2011,0.4604956219161341,0.5395043780838659
3197,Like a Boss,30399490,22169514,8229976,2020.csv,2020,0.7292725634541896,0.2707274365458105
3198,A Beautiful Wife,30385222,0,30385222,2007.csv,2007,0.0,1.0
3199,The Girl Next Door,30381722,14589444,15792278,2004.csv,2004,0.4802046440948936,0.5197953559051064
3200,S Storm,30381402,0,30381402,2016.csv,2016,0.0,1.0
3201,Yatterman,30365792,0,30365792,2009.csv,2009,0.0,1.0
3202,The Way of the Bug,30355804,0,30355804,2018.csv,2018,0.0,1.0
3203,Nocturnal Animals,30311857,10663357,19648500,2016.csv,2016,0.3517883117487655,0.6482116882512345
3204,Doraemon: Nobita and the New Steel Troops: ~Winged Angels~,30236973,0,30236973,2011.csv,2011,0.0,1.0
3205,The Great Debaters,30236407,30236407,0,2007.csv,2007,1.0,0.0
3206,Far from the Madding Crowd,30229977,12236500,17993477,2015.csv,2015,0.40478032781831097,0.595219672181689
3207,Eternal Moment,30186159,0,30186159,2011.csv,2011,0.0,1.0
3208,A Tale of Mari and Three Puppies,30183621,0,30183621,2007.csv,2007,0.0,1.0
3209,The Grand Heist,30158762,0,30158762,2012.csv,2012,0.0,1.0
3210,A Silent Voice: The Movie,30156463,310407,29846056,2016.csv,2016,0.010293216415996797,0.9897067835840032
3211,When the Game Stands Tall,30138754,30127963,10791,2014.csv,2014,0.9996419560012335,0.0003580439987665051
3212,The Rum Diary,30134958,13109815,17025143,2011.csv,2011,0.4350367768888213,0.5649632231111787
3213,Godsend,30120671,14379751,15740920,2004.csv,2004,0.47740473643498843,0.5225952635650115
3214,Clergy,30114115,0,30114115,2018.csv,2018,0.0,1.0
3215,My Own Swordsman,30082188,0,30082188,2011.csv,2011,0.0,1.0
3216,Shaun of the Dead,30076102,13542874,16533228,2004.csv,2004,0.45028687560642,0.54971312439358
3217,I Do: How to Get Married and Stay Single,30057369,0,30057369,2006.csv,2006,0.0,1.0
3218,Laws of Attraction,30031874,17871255,12160619,2003.csv,2003,0.5950762513188488,0.4049237486811512
3219,Solaris,30002758,14973382,15029376,2002.csv,2002,0.49906685245403104,0.500933147545969
3220,Natale a Beverly Hills,29976481,0,29976481,2009.csv,2009,0.0,1.0
3221,My Hero Academia: Heroes Rising,29971229,13304000,16667229,2019.csv,2019,0.4438923742499849,0.5561076257500152
3222,Reset 2017 Re-release,29949252,108970,29840282,2017.csv,2017,0.0036384881999724067,0.9963615118000276
3223,Small Time Crooks,29934477,17266359,12668118,2000.csv,2000,0.5768051000189514,0.4231948999810486
3224,Keeping Up with the Joneses,29918745,14904426,15014319,2016.csv,2016,0.4981634757741342,0.5018365242258658
3225,Rab Ne Bana Di Jodi,29914469,2078956,27835513,2008.csv,2008,0.0694966706579348,0.9305033293420653
3226,Pulse,29907685,20264436,9643249,2006.csv,2006,0.6775661840760995,0.32243381592390047
3227,Crows Zero II,29893636,0,29893636,2009.csv,2009,0.0,1.0
3228,The Four Feathers,29882645,18306166,11576479,2002.csv,2002,0.6126019299831056,0.3873980700168944
3229,The Bye Bye Man,29874280,22395806,7478474,2017.csv,2017,0.7496684773658143,0.2503315226341857
3230,Escape from Mogadishu,29874017,346271,29527746,2021.csv,2021,0.011591042476811872,0.9884089575231881
3231,Vikram,29843869,1770000,28073869,2022.csv,2022,0.05930866403414383,0.9406913359658562
3232,You Are the Apple of My Eye,29843025,0,29843025,2011.csv,2011,0.0,1.0
3233,Draft Day,29824199,28842237,981962,2014.csv,2014,0.9670749916871195,0.03292500831288042
3234,The Disaster Artist,29820616,21120616,8700000,2017.csv,2017,0.7082555236283516,0.2917444763716484
3235,Ice,29806210,0,29806210,2018.csv,2018,0.0,1.0
3236,Jackie,29777777,13960394,15817383,2016.csv,2016,0.46881921373781527,0.5311807862621847
3237,Torrente 4,29737384,0,29737384,2011.csv,2011,0.0,1.0
3238,Lissi und der wilde Kaiser,29733764,0,29733764,2007.csv,2007,0.0,1.0
3239,Battlefield Earth,29725663,21471685,8253978,2000.csv,2000,0.7223282118215496,0.2776717881784504
3240,The Swindlers,29721916,241916,29480000,2017.csv,2017,0.008139313764294335,0.9918606862357057
3241,Angel Eyes,29715606,24174218,5541388,2001.csv,2001,0.8135192666102787,0.1864807333897212
3242,The Raven,29699345,16008272,13691073,2012.csv,2012,0.5390109445174632,0.4609890554825367
3243,Masterminds,29674699,17368022,12306677,2016.csv,2016,0.5852804774868988,0.4147195225131011
3244,Amour,29652180,6739492,22912688,2012.csv,2012,0.22728487416439533,0.7727151258356046
3245,The Sorcerer and the White Snake,29649716,0,29649716,2011.csv,2011,0.0,1.0
3246,Death Note,29630359,0,29630359,2006.csv,2006,0.0,1.0
3247,Cursed,29621722,19297522,10324200,2005.csv,2005,0.6514652321698245,0.34853476783017545
3248,An American Haunting,29612137,16298046,13314091,2006.csv,2006,0.5503839861337937,0.44961601386620625
3249,The Fox & the Child,29610210,0,29610210,2007.csv,2007,0.0,1.0
3250,W.,29560587,25534493,4026094,2008.csv,2008,0.8638019603602595,0.1361980396397406
3251,In the Valley of Elah,29541790,6777741,22764049,2007.csv,2007,0.22942892086092279,0.7705710791390772
3252,20th Century Boys 2: The Last Hope,29502213,0,29502213,2009.csv,2009,0.0,1.0
3253,Rajneeti,29459596,1514558,27945038,2010.csv,2010,0.051411363550267285,0.9485886364497327
3254,The Pledge,29419291,19733089,9686202,2001.csv,2001,0.670753384233495,0.32924661576650505
3255,The Valet,29414553,1926800,27487753,2006.csv,2006,0.0655049899959384,0.9344950100040615
3256,City by the Sea,29414087,22449000,6965087,2002.csv,2002,0.7632057388012757,0.23679426119872427
3257,Luther,29413900,5791328,23622572,2003.csv,2003,0.19689085772372925,0.8031091422762707
3258,The Losers,29397654,23591432,5806222,2010.csv,2010,0.8024936955853689,0.19750630441463118
3259,Free Solo,29390279,17541090,11849189,2018.csv,2018,0.5968330549022689,0.4031669450977311
3260,Bugs!,29388999,19063544,10325455,2003.csv,2003,0.6486625828936875,0.35133741710631244
3261,All About My Wife,29382038,0,29382038,2012.csv,2012,0.0,1.0
3262,Baby Boy,29381649,28734552,647097,2001.csv,2001,0.977976151032231,0.022023848967768964
3263,Alibi.com,29370592,0,29370592,2017.csv,2017,0.0,1.0
3264,Across the Universe,29367143,24343673,5023470,2007.csv,2007,0.828942502169857,0.17105749783014304
3265,Nurse Betty,29360400,25170054,4190346,2000.csv,2000,0.8572789880246863,0.1427210119753137
3266,Mr. Holmes,29355203,17737646,11617557,2015.csv,2015,0.6042419805443008,0.3957580194556992
3267,Galapagos,29349172,18630372,10718800,1999.csv,1999,0.6347835639111046,0.3652164360888955
3268,Rowdy Rathore,29342463,777373,28565090,2012.csv,2012,0.02649310659435781,0.9735068934056422
3269,The Witches,29333671,203571,29130100,2020.csv,2020,0.006939840567517104,0.9930601594324829
3270,Sword Art Online the Movie: Ordinal Scale,29322339,1522976,27799363,2017.csv,2017,0.05193910349375607,0.9480608965062439
3271,Christmas on the Nile,29320869,0,29320869,2002.csv,2002,0.0,1.0
3272,Silent Witness,29315945,0,29315945,2013.csv,2013,0.0,1.0
3273,The Class,29303505,3766810,25536695,2008.csv,2008,0.12854469115554606,0.8714553088444539
3274,Big Eyes,29253166,14482031,14771135,2014.csv,2014,0.495058586137309,0.504941413862691
3275,Fall In Love At First Kiss,29206238,0,29206238,2019.csv,2019,0.0,1.0
3276,The Young Victoria,29181829,11001272,18180557,2009.csv,2009,0.3769904895268902,0.6230095104731098
3277,The Santa Claus Gang,29181330,0,29181330,2010.csv,2010,0.0,1.0
3278,Dark Figure of Crime,29176133,0,29176133,2018.csv,2018,0.0,1.0
3279,Flight Crew,29171110,0,29171110,2016.csv,2016,0.0,1.0
3280,Singh Is King,29169677,2159376,27010301,2008.csv,2008,0.0740281080246449,0.9259718919753551
3281,Unfair: The Answer,29166054,0,29166054,2011.csv,2011,0.0,1.0
3282,Viking,29161298,0,29161298,2016.csv,2016,0.0,1.0
3283,Yu-Gi-Oh!: The Movie - Pyramid of Light,29144802,19765868,9378934,2004.csv,2004,0.6781953090640314,0.32180469093596864
3284,Dragon,29140858,0,29140858,2011.csv,2011,0.0,1.0
3285,Special ID,29139936,12666,29127270,2013.csv,2013,0.0004346612154535961,0.9995653387845465
3286,Cold Creek Manor,29119434,21386011,7733423,2003.csv,2003,0.7344239932685505,0.26557600673144954
3287,Sacrifice,29093560,29792,29063768,2010.csv,2010,0.0010240066873906115,0.9989759933126093
3288,St. Trinian's,29066483,0,29066483,2007.csv,2007,0.0,1.0
3289,The Fatal Encounter,29060186,0,29060186,2014.csv,2014,0.0,1.0
3290,Pad Man,29045020,1670192,27374828,2018.csv,2018,0.057503558269197265,0.9424964417308027
3291,Far from Heaven,29027914,15901849,13126065,2002.csv,2002,0.5478123229936537,0.4521876770063464
3292,SPEC: Heaven,29023960,0,29023960,2012.csv,2012,0.0,1.0
3293,New in Town,29010817,16734283,12276534,2009.csv,2009,0.5768290841309295,0.4231709158690705
3294,The Unbroken,29000322,0,29000322,2009.csv,2009,0.0,1.0
3295,Shorts,28972508,20919166,8053342,2009.csv,2009,0.7220350409429519,0.27796495905704816
3296,Recep Ivedik 5,28952258,0,28952258,2017.csv,2017,0.0,1.0
3297,Family Honor,28903789,0,28903789,2002.csv,2002,0.0,1.0
3298,M.S. Dhoni: The Untold Story,28903047,1801550,27101497,2016.csv,2016,0.06233079854867897,0.937669201451321
3299,We Were There: True Love,28876929,0,28876929,2012.csv,2012,0.0,1.0
3300,The Unbearable Weight of Massive Talent,28866880,20300157,8566723,2022.csv,2022,0.7032334980434325,0.2967665019565675
3301,Agent Cody Banks 2: Destination London,28818995,23630159,5188836,2004.csv,2004,0.8199508345103638,0.18004916548963626
3302,Kokowääh 2,28811936,0,28811936,2013.csv,2013,0.0,1.0
3303,Boiler Room,28780255,16970581,11809674,2000.csv,2000,0.5896605502626714,0.4103394497373286
3304,Bol Bachchan,28775262,1216258,27559004,2012.csv,2012,0.04226748656536993,0.9577325134346301
3305,Mirai,28756961,812794,27944167,2018.csv,2018,0.028264252262260953,0.9717357477377391
3306,Pope Joan,28748076,0,28748076,2009.csv,2009,0.0,1.0
3307,Judwaa 2,28733523,1431255,27302268,2017.csv,2017,0.04981133013170713,0.9501886698682929
3308,Yolki 2,28719002,0,28719002,2011.csv,2011,0.0,1.0
3309,Bath Buddy,28700000,0,28700000,2020.csv,2020,0.0,1.0
3310,Master,28692230,0,28692230,2021.csv,2021,0.0,1.0
3311,The Suspect,28674130,218693,28455437,2013.csv,2013,0.007626839942484741,0.9923731600575153
3312,Wrong Turn,28650575,15418790,13231785,2003.csv,2003,0.5381668605254868,0.46183313947451315
3313,The Fortress,28645448,252895,28392553,2017.csv,2017,0.008828453302598025,0.9911715466974019
3314,Love & Mercy,28641776,12551031,16090745,2015.csv,2015,0.43820714888629814,0.5617928511137019
3315,Maya the Bee Movie,28638603,0,28638603,2014.csv,2014,0.0,1.0
3316,The Four 2,28599970,0,28599970,2013.csv,2013,0.0,1.0
3317,Pokémon the Movie: Diancie and the Cocoon of Destruction,28595105,0,28595105,2014.csv,2014,0.0,1.0
3318,Scoob!,28559165,2188425,26370740,2020.csv,2020,0.07662776555266934,0.9233722344473306
3319,Recep Ivedik,28548025,0,28548025,2008.csv,2008,0.0,1.0
3320,The Out-of-Towners,28544120,28544120,0,1999.csv,1999,1.0,0.0
3321,Flying Colors,28525563,0,28525563,2015.csv,2015,0.0,1.0
3322,Heist,28510652,23510841,4999811,2001.csv,2001,0.8246335790566979,0.17536642094330218
3323,Ala Vaikunthapurramuloo,28477890,0,28477890,2020.csv,2020,0.0,1.0
3324,Go,28451622,16943454,11508168,1999.csv,1999,0.5955180340860707,0.40448196591392926
3325,Deranged,28444173,0,28444173,2012.csv,2012,0.0,1.0
3326,The Last Warrior: Root of Evil,28357398,0,28357398,2021.csv,2021,0.0,1.0
3327,The Kiyosu Conference,28338665,0,28338665,2013.csv,2013,0.0,1.0
3328,I Give It a Year,28328531,34657,28293874,2013.csv,2013,0.0012233955936507969,0.9987766044063492
3329,Brown Sugar,28316451,27363891,952560,2002.csv,2002,0.9663601911129329,0.0336398088870671
3330,Gully Boy,28299498,5566534,22732964,2019.csv,2019,0.19670080366796613,0.8032991963320338
3331,Thunderbirds,28283637,6880917,21402720,2004.csv,2004,0.24328260895159984,0.7567173910484002
3332,The Master,28258060,16377274,11880786,2012.csv,2012,0.5795611588339752,0.42043884116602487
3333,Fan,28240000,2300000,25940000,2016.csv,2016,0.08144475920679886,0.9185552407932012
3334,The Upside of Anger,28237488,18761993,9475495,2005.csv,2005,0.664435625435237,0.33556437456476296
3335,The Spanish Apartment,28193749,1067438,27126311,2002.csv,2002,0.03786080382569909,0.9621391961743009
3336,Case 39,28190603,13261851,14928752,2009.csv,2009,0.4704351659310019,0.5295648340689981
3337,The Deep End of the Ocean,28121100,13898649,14222451,1999.csv,1999,0.4942427216574032,0.5057572783425969
3338,"Yôkai Watch: the Movie: The Flying Whale and the Grand Adventure of the Double Worlds, Meow!",28110245,0,28110245,2016.csv,2016,0.0,1.0
3339,Triumph in the Skies,28085162,0,28085162,2015.csv,2015,0.0,1.0
3340,Tristan + Isolde,28047963,14734633,13313330,2006.csv,2006,0.52533700932221,0.47466299067779005
3341,Welcome to Germany,28036021,0,28036021,2016.csv,2016,0.0,1.0
3342,Pokemon 4Ever: Celebi - Voice of the Forest,28023563,1727447,26296116,2002.csv,2002,0.06164266121335107,0.938357338786649
3343,Your Highness,28013733,21596445,6417288,2011.csv,2011,0.7709234967007075,0.22907650329929252
3344,The Tailor of Panama,28008462,13729742,14278720,2001.csv,2001,0.4901997831940933,0.5098002168059067
3345,Mandela: Long Walk to Freedom,27985788,8323085,19662703,2013.csv,2013,0.29740398948208996,0.70259601051791
3346,The Brothers Grimsby,27979040,6874837,21104203,2016.csv,2016,0.24571382720779555,0.7542861727922044
3347,What Happened to Monday,27975429,0,27975429,2017.csv,2017,0.0,1.0
3348,The 33,27972023,12227722,15744301,2015.csv,2015,0.4371411392018375,0.5628588607981625
3349,The Little Vampire,27965865,13572400,14393465,2000.csv,2000,0.4853202287860576,0.5146797712139424
3350,The Brothers,27958191,27457409,500782,2001.csv,2001,0.9820881830301539,0.017911816969846152
3351,Priceless,27949650,2165188,25784462,2006.csv,2006,0.07746744592508314,0.9225325540749169
3352,The Divine Move,27926871,136707,27790164,2014.csv,2014,0.004895177837860891,0.9951048221621391
3353,Monster Family,27890108,127259,27762849,2017.csv,2017,0.004562872255639885,0.9954371277443601
3354,Mrs. Henderson Presents,27876417,11036366,16840051,2005.csv,2005,0.3959033185649361,0.6040966814350639
3355,The Beguiled,27869129,10709995,17159134,2017.csv,2017,0.3842960072415611,0.6157039927584389
3356,When Larry Meets Mary,27863090,0,27863090,2016.csv,2016,0.0,1.0
3357,Dark Skies,27858103,17418667,10439436,2013.csv,2013,0.6252639312877837,0.3747360687122163
3358,The 355,27834721,14570455,13264266,2022.csv,2022,0.5234633032607009,0.4765366967392991
3359,Manual of Love 2,27833482,0,27833482,2007.csv,2007,0.0,1.0
3360,The Other Sister,27807627,27807627,0,1999.csv,1999,1.0,0.0
3361,The Lady Shogun and Her Men,27769952,0,27769952,2010.csv,2010,0.0,1.0
3362,Love & Basketball,27728118,27459615,268503,2000.csv,2000,0.9903165804473278,0.009683419552672129
3363,Ruby & Quentin,27720972,312824,27408148,2003.csv,2003,0.011284741386413145,0.9887152586135869
3364,Appaloosa,27712362,20211394,7500968,2008.csv,2008,0.7293277274596802,0.2706722725403197
3365,Love Strikes!,27707149,0,27707149,2011.csv,2011,0.0,1.0
3366,Recep Ivedik 2,27699692,0,27699692,2009.csv,2009,0.0,1.0
3367,Kim Ji-young: Born 1982,27696393,0,27696393,2019.csv,2019,0.0,1.0
3368,Default,27694043,203775,27490268,2018.csv,2018,0.007358080580722721,0.9926419194192773
3369,Dirty Dancing: Havana Nights,27685016,14161590,13523426,2004.csv,2004,0.5115254403320554,0.48847455966794456
3370,Nebraska,27682872,17654912,10027960,2013.csv,2013,0.6377557935462765,0.36224420645372346
3371,Traitor,27674464,23530831,4143633,2008.csv,2008,0.8502723304776563,0.1497276695223438
3372,The Quiet American,27674124,12988801,14685323,2002.csv,2002,0.46934822580111296,0.530651774198887
3373,Bride Wars,27670000,0,27670000,2015.csv,2015,0.0,1.0
3374,Ice Princess,27645491,24402491,3243000,2005.csv,2005,0.882693347714461,0.11730665228553908
3375,The Last Castle,27642707,18244060,9398647,2001.csv,2001,0.659995419406645,0.34000458059335503
3376,The Road,27639579,8117000,19522579,2009.csv,2009,0.29367306933293014,0.7063269306670699
3377,Pokémon Ranger and the Temple of the Sea,27638625,0,27638625,2006.csv,2006,0.0,1.0
3378,Goal! The Dream Begins,27610873,4283255,23327618,2005.csv,2005,0.15512928548112187,0.8448707145188781
3379,One Cut of the Dead,27590180,52406,27537774,2018.csv,2018,0.0018994439325876091,0.9981005560674124
3380,Nicholas on Holiday,27567832,0,27567832,2014.csv,2014,0.0,1.0
3381,Cirque du Soleil: Journey of Man,27538359,15627434,11910925,2000.csv,2000,0.5674787666178657,0.43252123338213433
3382,The Women on the 6th Floor,27533970,719823,26814147,2011.csv,2011,0.026143087974600104,0.9738569120253999
3383,Grace of Monaco,27515247,0,27515247,2014.csv,2014,0.0,1.0
3384,The Happytime Murders,27506452,20706452,6800000,2018.csv,2018,0.7527852737968532,0.2472147262031468
3385,The Incredible Burt Wonderstone,27437881,22537881,4900000,2013.csv,2013,0.8214147805364416,0.17858521946355843
3386,Frost/Nixon,27426335,18622031,8804304,2008.csv,2008,0.678983575457676,0.321016424542324
3387,Yesterday Once More,27411872,0,27411872,2016.csv,2016,0.0,1.0
3388,Left Behind,27405896,14019924,13385972,2014.csv,2014,0.5115659783573578,0.48843402164264216
3389,Irrational Man,27391084,4030360,23360724,2015.csv,2015,0.14714131065422603,0.852858689345774
3390,Legend of the Fist: The Return of Chen Zhen,27390678,50433,27340245,2010.csv,2010,0.0018412468650830767,0.998158753134917
3391,Ella Enchanted,27388767,22918387,4470380,2004.csv,2004,0.8367805312301938,0.16321946876980625
3392,Detective K: Secret of the Lost Island,27387870,185367,27202503,2015.csv,2015,0.006768215271943382,0.9932317847280566
3393,Gorko!,27369902,0,27369902,2013.csv,2013,0.0,1.0
3394,Midnight Sun,27365467,9561064,17804403,2018.csv,2018,0.34938428056060583,0.6506157194393942
3395,Pokémon: Mewtwo Strikes Back - Evolution,27347118,0,27347118,2019.csv,2019,0.0,1.0
3396,The Last Mimzy,27308918,21471047,5837871,2007.csv,2007,0.7862284034834335,0.2137715965165665
3397,Dororo,27308865,0,27308865,2007.csv,2007,0.0,1.0
3398,Stay Alive,27298695,23086480,4212215,2006.csv,2006,0.8456990343311283,0.15430096566887172
3399,Ramona and Beezus,27293743,26167002,1126741,2010.csv,2010,0.9587179742990912,0.04128202570090881
3400,To the Fore,27267799,0,27267799,2015.csv,2015,0.0,1.0
3401,American Ultra,27262374,14440985,12821389,2015.csv,2015,0.5297038695162791,0.4702961304837209
3402,Forever the Moment,27259300,0,27259300,2008.csv,2008,0.0,1.0
3403,Public Enemy 3,27226420,0,27226420,2008.csv,2008,0.0,1.0
3404,VIP Policeman,27222681,0,27222681,2018.csv,2018,0.0,1.0
3405,Sorority Row,27206120,11965282,15240838,2009.csv,2009,0.4398011182777993,0.5601988817222008
3406,Khumba,27187375,1029,27186346,2013.csv,2013,3.7848449877930475e-05,0.999962151550122
3407,The Protector,27165581,12044087,15121494,2005.csv,2005,0.44335834378068334,0.5566416562193166
3408,Splice 2010 Re-release,27127620,17010170,10117450,2010.csv,2010,0.627042475528631,0.37295752447136904
3409,Shoot 'Em Up,27122238,12807139,14315099,2007.csv,2007,0.47220067164074,0.52779932835926
3410,Let Me In,27093592,12134935,14958657,2010.csv,2010,0.4478894861928976,0.5521105138071024
3411,Ghost Town,27090159,13367624,13722535,2008.csv,2008,0.4934494478234698,0.5065505521765302
3412,Joy of Fatherhood,27088817,0,27088817,2014.csv,2014,0.0,1.0
3413,My Neighbor Totoro 2018 Re-release,27083857,1144649,25939208,2018.csv,2018,0.042263145902741994,0.9577368540972581
3414,Rendition,27066382,9736045,17330337,2007.csv,2007,0.3597098792147395,0.6402901207852605
3415,Hitchcock,27039669,6008677,21030992,2012.csv,2012,0.22221710628188532,0.7777828937181147
3416,The Crime of Padre Amaro,26996738,5717044,21279694,2002.csv,2002,0.21176795507664667,0.7882320449233533
3417,Almost a Comedy,26990962,0,26990962,2019.csv,2019,0.0,1.0
3418,Clerks II,26984975,24148068,2836907,2006.csv,2006,0.8948708679552232,0.10512913204477677
3419,Observe and Report,26973554,24007324,2966230,2009.csv,2009,0.8900319179296877,0.10996808207031228
3420,The Baader Meinhof Complex,26937355,476270,26461085,2008.csv,2008,0.017680652016502735,0.9823193479834973
3421,Letters to Santa,26923513,0,26923513,2011.csv,2011,0.0,1.0
3422,Total Dhamaal,26911995,2167632,24744363,2019.csv,2019,0.08054519926895051,0.9194548007310495
3423,The Painted Veil,26910847,8060487,18850360,2006.csv,2006,0.2995255779203085,0.7004744220796915
3424,You're Next,26895481,18494006,8401475,2013.csv,2013,0.6876250326216512,0.3123749673783488
3425,The In-Laws,26891849,20453431,6438418,2003.csv,2003,0.7605810593388354,0.23941894066116465
3426,Jodhaa Akbar,26890354,3440718,23449636,2008.csv,2008,0.12795361489104978,0.8720463851089503
3427,Mr. Go,26835201,0,26835201,2013.csv,2013,0.0,1.0
3428,The Invisible,26810113,20578909,6231204,2007.csv,2007,0.7675800918854762,0.2324199081145238
3429,CHIPS,26800152,18600152,8200000,2017.csv,2017,0.6940315860895118,0.3059684139104883
3430,The Faces of My Gene,26796279,0,26796279,2018.csv,2018,0.0,1.0
3431,Black Book,26768563,4398532,22370031,2006.csv,2006,0.16431707596705883,0.8356829240329412
3432,Dearest,26723916,0,26723916,2012.csv,2012,0.0,1.0
3433,Dougal: American Edition,26711924,7438000,19273924,2005.csv,2005,0.27845242446781443,0.7215475755321855
3434,A Monster in Paris,26710392,0,26710392,2011.csv,2011,0.0,1.0
3435,Doraemon: Nobita in the Wan-Nyan Spacetime Odyssey,26663978,0,26663978,2004.csv,2004,0.0,1.0
3436,Architecture 101,26642354,0,26642354,2012.csv,2012,0.0,1.0
3437,A Cure for Wellness,26620002,8106986,18513016,2017.csv,2017,0.3045449057441844,0.6954550942558156
3438,Missing Link,26565710,16649539,9916171,2019.csv,2019,0.626730435587831,0.3732695644121689
3439,Mongol: The Rise of Genghis Khan,26527510,5705761,20821749,2007.csv,2007,0.215088449688644,0.7849115503113561
3440,American Underdog,26514814,26514814,0,2021.csv,2021,1.0,0.0
3441,Chaos Walking,26508132,13287908,13220224,2021.csv,2021,0.501276664836285,0.49872333516371503
3442,No Manches Frida 2,26493648,9270920,17222728,2019.csv,2019,0.3499299152762957,0.6500700847237043
3443,A Hard Day,26488847,19004,26469843,2014.csv,2014,0.0007174340204388662,0.9992825659795611
3444,The Break Up Man,26477012,0,26477012,2013.csv,2013,0.0,1.0
3445,The Way Way Back,26474920,21506546,4968374,2013.csv,2013,0.8123365811870253,0.18766341881297469
3446,We Are the Nobles,26433651,0,26433651,2013.csv,2013,0.0,1.0
3447,Ivan Tsarevich & the Grey Wolf,26420475,0,26420475,2011.csv,2011,0.0,1.0
3448,Mad Money,26412163,20668843,5743320,2008.csv,2008,0.7825501834136038,0.2174498165863962
3449,Dancing Queen,26411266,0,26411266,2012.csv,2012,0.0,1.0
3450,Emma.,26404660,10055355,16349305,2020.csv,2020,0.3808174390429568,0.6191825609570432
3451,Center Stage,26385941,17200925,9185016,2000.csv,2000,0.65189734942559,0.3481026505744101
3452,Only the Brave,26351322,18343983,8007339,2017.csv,2017,0.6961314123063731,0.3038685876936269
3453,Saving Grace,26330482,12178602,14151880,2000.csv,2000,0.46252863886046597,0.537471361139534
3454,All About the Benjamins,26306533,25916319,390214,2002.csv,2002,0.9851666504286216,0.014833349571378334
3455,Twenty Two,26289378,46796,26242582,2017.csv,2017,0.0017800345067121785,0.9982199654932878
3456,Orange,26261536,0,26261536,2015.csv,2015,0.0,1.0
3457,Detective Conan: The Private Eyes' Requiem,26251232,0,26251232,2006.csv,2006,0.0,1.0
3458,Aloha,26250020,21067116,5182904,2015.csv,2015,0.8025561885286182,0.19744381147138174
3459,The Stolen Years,26249553,0,26249553,2013.csv,2013,0.0,1.0
3460,Apollo 18,26236153,17687709,8548444,2011.csv,2011,0.6741731152429246,0.3258268847570755
3461,The Confidence Man JP,26228317,0,26228317,2019.csv,2019,0.0,1.0
3462,One Night Surprise,26220159,0,26220159,2013.csv,2013,0.0,1.0
3463,Typhoon,26179656,139059,26040597,2005.csv,2005,0.005311719909535863,0.9946882800904642
3464,The Whole Ten Yards,26170671,16328471,9842200,2004.csv,2004,0.6239225199842985,0.37607748001570157
3465,Lesson of the Evil,26167224,0,26167224,2012.csv,2012,0.0,1.0
3466,The Zookeeper's Wife,26152835,17571660,8581175,2017.csv,2017,0.6718835644395722,0.32811643556042774
3467,9th Company,26146165,0,26146165,2005.csv,2005,0.0,1.0
3468,Badrinath Ki Dulhania,26134309,1993259,24141050,2017.csv,2017,0.0762698183449197,0.9237301816550803
3469,Badhaai Ho,26125610,0,26125610,2018.csv,2018,0.0,1.0
3470,Top Five,26117471,25317471,800000,2014.csv,2014,0.9693691628871723,0.030630837112827655
3471,An Education,26096852,12574914,13521938,2009.csv,2009,0.48185558932548644,0.5181444106745136
3472,Saving Silverman,26086706,19402030,6684676,2001.csv,2001,0.7437516258281134,0.2562483741718866
3473,Hichki,26055222,330279,25724943,2018.csv,2018,0.012676115367583512,0.9873238846324165
3474,Platinum Data,26052718,0,26052718,2013.csv,2013,0.0,1.0
3475,Iceman,26033917,7679,26026238,2014.csv,2014,0.0002949613767302093,0.9997050386232698
3476,Bratz,26013153,10010209,16002944,2007.csv,2007,0.38481336729922744,0.6151866327007726
3477,Agneepath,26001696,1986748,24014948,2012.csv,2012,0.07640840043664844,0.9235915995633516
3478,The Courier,26001227,6613432,19387795,2021.csv,2021,0.25435076583116634,0.7456492341688337
3479,A Prairie Home Companion,25978867,20342852,5636015,2006.csv,2006,0.783053856813694,0.216946143186306
3480,The Light Between Oceans,25975621,12545979,13429642,2016.csv,2016,0.48299053177592943,0.5170094682240706
3481,A Chinese Odyssey: Part 2 - Cinderella 2017 Re-release,25960664,0,25960664,2017.csv,2017,0.0,1.0
3482,Love Off the Cuff,25959989,0,25959989,2017.csv,2017,0.0,1.0
3483,The Confidence Man JP: The Movie,25958189,0,25958189,2019.csv,2019,0.0,1.0
3484,White Boy Rick,25957482,24011188,1946294,2018.csv,2018,0.925019922964793,0.07498007703520704
3485,Meet Miss Anxiety,25948636,0,25948636,2014.csv,2014,0.0,1.0
3486,"Paul, Apostle of Christ",25915966,17560475,8355491,2018.csv,2018,0.6775929170458087,0.32240708295419124
3487,Huevos: Little Rooster's Egg-cellent Adventure,25892561,9080818,16811743,2015.csv,2015,0.3507114649647827,0.6492885350352172
3488,Gekijouban SPEC: Kurôzu - Zen no hen,25860404,0,25860404,2013.csv,2013,0.0,1.0
3489,Rollerball,25852764,18990798,6861966,2002.csv,2002,0.7345751502624632,0.26542484973753677
3490,Boys and Girls,25850615,21799652,4050963,2000.csv,2000,0.8432933607188843,0.15670663928111575
3491,Dügün Dernek 2: Sünnet,25836668,0,25836668,2015.csv,2015,0.0,1.0
3492,The Alamo,25819961,22414961,3405000,2004.csv,2004,0.8681252849297487,0.13187471507025128
3493,Leap,25818882,83074,25735808,2020.csv,2020,0.00321756767004861,0.9967824323299513
3494,Unbeatable,25816154,0,25816154,2013.csv,2013,0.0,1.0
3495,Rust and Bone,25807712,2062027,23745685,2012.csv,2012,0.07989964395138942,0.9201003560486106
3496,Our Idiot Brother,25804448,24816118,988330,2011.csv,2011,0.9616992388289026,0.038300761171097326
3497,Fair Game,25798915,9540691,16258224,2010.csv,2010,0.3698097768840279,0.6301902231159722
3498,"The Gangster, the Cop, the Devil",25775371,216494,25558877,2019.csv,2019,0.008399258346271718,0.9916007416537282
3499,Man on the Edge,25774679,0,25774679,2013.csv,2013,0.0,1.0
3500,Champions,25766564,0,25766564,2018.csv,2018,0.0,1.0
3501,RocknRolla,25740863,5700626,20040237,2008.csv,2008,0.22146211647993308,0.7785378835200669
3502,A Beautiful Planet,25730120,15650615,10079505,2016.csv,2016,0.6082604744944835,0.3917395255055165
3503,Fireworks,25672406,525280,25147126,2017.csv,2017,0.020460879280266915,0.979539120719733
3504,Natale a Miami,25643184,0,25643184,2005.csv,2005,0.0,1.0
3505,The Roundup,25623521,0,25623521,2010.csv,2010,0.0,1.0
3506,Jonah: A VeggieTales Movie,25615231,25581229,34002,2002.csv,2002,0.9986725866341006,0.0013274133658993745
3507,Father Figures,25601244,17501244,8100000,2017.csv,2017,0.6836091246191005,0.31639087538089944
3508,Coco,25593707,0,25593707,2009.csv,2009,0.0,1.0
3509,"Love, Rosie",25574387,20431,25553956,2014.csv,2014,0.0007988852284123173,0.9992011147715877
3510,Mr. Donkey,25537759,356255,25181504,2016.csv,2016,0.013950127730471574,0.9860498722695284
3511,Look Who's Back,25513752,0,25513752,2015.csv,2015,0.0,1.0
3512,The Tiger and the Snow,25460023,10167,25449856,2005.csv,2005,0.00039933192519111236,0.9996006680748089
3513,Doraemon the Movie: The New Records of Nobita's Spaceblazer,25422212,0,25422212,2009.csv,2009,0.0,1.0
3514,Grindhouse,25422088,25037897,384191,2007.csv,2007,0.9848875119935073,0.015112488006492621
3515,Money,25403753,0,25403753,2017.csv,2017,0.0,1.0
3516,Head Over Heels 2,25402893,0,25402893,2012.csv,2012,0.0,1.0
3517,The Hitcher,25399945,16472961,8926984,2007.csv,2007,0.6485431759793181,0.35145682402068196
3518,In America,25382911,15539656,9843255,2003.csv,2003,0.6122093718880391,0.38779062811196086
3519,Keys To The Heart,25375866,75134,25300732,2018.csv,2018,0.0029608447648643795,0.9970391552351356
3520,Serial Teachers 2,25364150,0,25364150,2015.csv,2015,0.0,1.0
3521,Christmas in South Africa,25362517,0,25362517,2010.csv,2010,0.0,1.0
3522,A Haunted House 2,25358716,17329486,8029230,2014.csv,2014,0.6833739531607199,0.31662604683928003
3523,You Are So Beautiful,25329576,0,25329576,2006.csv,2006,0.0,1.0
3524,And So It Goes,25312387,15160801,10151586,2014.csv,2014,0.5989478985130877,0.40105210148691234
3525,The Last Legion,25303038,5933494,19369544,2007.csv,2007,0.23449729633255895,0.765502703667441
3526,Nada sô sô,25300338,0,25300338,2006.csv,2006,0.0,1.0
3527,Bodies at Rest,25293853,0,25293853,2019.csv,2019,0.0,1.0
3528,Enough Said,25288872,17550872,7738000,2013.csv,2013,0.6940156128751017,0.3059843871248983
3529,Corky Romano,25272752,23980304,1292448,2001.csv,2001,0.9488600212592597,0.05113997874074022
3530,Kabhi Alvida Naa Kehna,25229168,3275444,21953724,2006.csv,2006,0.12982766613627528,0.8701723338637247
3531,I'm a Cat Stalker,25221446,0,25221446,2008.csv,2008,0.0,1.0
3532,North Country,25211175,18337722,6873453,2005.csv,2005,0.7273648292870126,0.2726351707129874
3533,Biutiful,25147786,5101237,20046549,2010.csv,2010,0.20285034237208793,0.797149657627912
3534,Mt. Tsurugidake,25134437,0,25134437,2009.csv,2009,0.0,1.0
3535,On the Other Side of the Tracks,25109572,9572,25100000,2012.csv,2012,0.0003812092057961004,0.9996187907942039
3536,Born in China,25081168,13873211,11207957,2016.csv,2016,0.5531325734112542,0.4468674265887458
3537,Race,25070261,19206207,5864054,2016.csv,2016,0.7660952153629353,0.2339047846370646
3538,Herutâ sukerutâ,25066699,0,25066699,2012.csv,2012,0.0,1.0
3539,The Wood,25059640,25059640,0,1999.csv,1999,1.0,0.0
3540,The Last Exorcism Part II,25051865,15179302,9872563,2013.csv,2013,0.6059150486400913,0.39408495135990873
3541,Call of Heroes,25040561,0,25040561,2016.csv,2016,0.0,1.0
3542,Before the Devil Knows You're Dead,25037657,7084227,17953430,2007.csv,2007,0.2829428887854802,0.7170571112145198
3543,Free State of Jones,25035950,20810036,4225914,2016.csv,2016,0.8312061655339622,0.16879383446603785
3544,Six Degrees of Celebration,25030264,0,25030264,2010.csv,2010,0.0,1.0
3545,The Last Tycoon,25009914,0,25009914,2012.csv,2012,0.0,1.0
3546,Georgia Rule,25000167,19103072,5897095,2007.csv,2007,0.7641177756932583,0.23588222430674163
3547,"Me, Myself and Mum",24991467,0,24991467,2013.csv,2013,0.0,1.0
3548,Whiskey Tango Foxtrot,24972139,23083334,1888805,2016.csv,2016,0.924363507667485,0.07563649233251504
3549,A Single Man,24964890,9176000,15788890,2009.csv,2009,0.36755619592155225,0.6324438040784478
3550,Booksmart,24959607,22680962,2278645,2019.csv,2019,0.9087066955821861,0.09129330441781396
3551,The Way Home,24952738,445367,24507371,2002.csv,2002,0.017848422084983218,0.9821515779150167
3552,Housefull 2,24922847,1791780,23131067,2012.csv,2012,0.07189307064317331,0.9281069293568267
3553,April Snow,24873159,0,24873159,2005.csv,2005,0.0,1.0
3554,The Father,24855200,2122771,22732429,2020.csv,2020,0.08540550870642763,0.9145944912935724
3555,Seed of Chucky,24829644,17083732,7745912,2004.csv,2004,0.6880377342502373,0.31196226574976266
3556,The Kashmir Files,24821898,1485000,23336898,2022.csv,2022,0.059826206682502686,0.9401737933174973
3557,Wild City,24817852,34866,24782986,2015.csv,2015,0.0014048758127818636,0.9985951241872182
3558,The Miracle of Bern,24816394,0,24816394,2003.csv,2003,0.0,1.0
3559,Elle s'appelait Sarah,24792815,7693187,17099628,2010.csv,2010,0.31029905236658284,0.6897009476334172
3560,Eyyvah Eyvah 2,24792348,0,24792348,2011.csv,2011,0.0,1.0
3561,Lottery Ticket,24719879,24719879,0,2010.csv,2010,1.0,0.0
3562,Big Miracle,24719215,20157300,4561915,2012.csv,2012,0.815450652458017,0.18454934754198302
3563,Bride & Prejudice,24716440,6605592,18110848,2004.csv,2004,0.26725499303297723,0.7327450069670227
3564,Kaiji: Jinsei gyakuten gêmu,24709016,0,24709016,2009.csv,2009,0.0,1.0
3565,Super 30,24701637,2269878,22431759,2019.csv,2019,0.09189180457959123,0.9081081954204088
3566,The Shipping News,24690441,11434216,13256225,2001.csv,2001,0.4631029474119154,0.5368970525880846
3567,Soulmate,24684439,0,24684439,2016.csv,2016,0.0,1.0
3568,Drug War,24676341,128195,24548146,2013.csv,2013,0.005195057079167451,0.9948049429208325
3569,Punch-Drunk Love,24665649,17844216,6821433,2002.csv,2002,0.7234440091156734,0.27655599088432664
3570,Ready,24663361,955148,23708213,2011.csv,2011,0.03872740621199195,0.961272593788008
3571,Liar Game: The Final Stage,24658706,0,24658706,2010.csv,2010,0.0,1.0
3572,The Death of Stalin,24646055,8047856,16598199,2017.csv,2017,0.32653728963925466,0.6734627103607453
3573,The Snow Queen 3: Fire and Ice,24644317,0,24644317,2016.csv,2016,0.0,1.0
3574,Sparkle,24637800,24397469,240331,2012.csv,2012,0.9902454358749564,0.009754564125043632
3575,The Players,24629152,10854,24618298,2012.csv,2012,0.00044069726801799754,0.999559302731982
3576,Liar Game: Reborn,24549726,0,24549726,2012.csv,2012,0.0,1.0
3577,Joe Somebody,24516772,22771646,1745126,2001.csv,2001,0.9288190957602412,0.07118090423975881
3578,Podium,24511116,0,24511116,2004.csv,2004,0.0,1.0
3579,Race,24503269,1367024,23136245,2008.csv,2008,0.05578945405202873,0.9442105459479713
3580,The Corruptor,24493601,15164492,9329109,1999.csv,1999,0.6191205613253845,0.3808794386746155
3581,God's Not Dead 2,24487848,20774575,3713273,2016.csv,2016,0.8483626245964937,0.15163737540350627
3582,Skyfire,24444590,1105,24443485,2019.csv,2019,4.5204276283627584e-05,0.9999547957237164
3583,The Tale of The Princess Kaguya,24434485,703232,23731253,2013.csv,2013,0.028780307831329368,0.9712196921686707
3584,The 8-Year Engagement,24425963,0,24425963,2017.csv,2017,0.0,1.0
3585,Stan & Ollie,24420923,5470235,18950688,2018.csv,2018,0.22399788083357866,0.7760021191664214
3586,Down to You,24419914,20069008,4350906,2000.csv,2000,0.8218295936668737,0.1781704063331263
3587,If I Were You 2,24415116,0,24415116,2009.csv,2009,0.0,1.0
3588,The Next Best Thing,24362772,14990582,9372190,2000.csv,2000,0.61530691170939,0.38469308829060994
3589,Detective Conan: Crossroad in the Ancient Capital,24342320,0,24342320,2003.csv,2003,0.0,1.0
3590,The Witch: Part 1 - The Subversion,24340302,0,24340302,2018.csv,2018,0.0,1.0
3591,Nowhere in Africa,24322180,6180200,18141980,2001.csv,2001,0.25409728897656375,0.7459027110234362
3592,Tanguy,24272365,0,24272365,2001.csv,2001,0.0,1.0
3593,The Great Beauty,24271739,2852400,21419339,2013.csv,2013,0.11751939158541545,0.8824806084145845
3594,Trance,24261569,2328743,21932826,2013.csv,2013,0.09598484747626998,0.90401515252373
3595,The Accidental Detective 2: In Action,24243825,179045,24064780,2018.csv,2018,0.0073851795250955655,0.9926148204749045
3596,Camping 3,24224579,0,24224579,2016.csv,2016,0.0,1.0
3597,Jolly LLB 2,24214186,1654254,22559932,2017.csv,2017,0.06831755566757437,0.9316824443324256
3598,The Railway Man,24174885,4438438,19736447,2013.csv,2013,0.18359706778336277,0.8164029322166372
3599,The Way Back,24172201,2701859,21470342,2010.csv,2010,0.11177546471668012,0.8882245352833199
3600,The Guru,24128852,3095506,21033346,2002.csv,2002,0.12829064557236292,0.8717093544276371
3601,The Founder,24121245,12786053,11335192,2016.csv,2016,0.5300743390318369,0.46992566096816313
3602,Out of Inferno,24109886,0,24109886,2013.csv,2013,0.0,1.0
3603,Guru,24108727,2096000,22012727,2007.csv,2007,0.08693947216707046,0.9130605278329296
3604,Start-Up,24106579,0,24106579,2019.csv,2019,0.0,1.0
3605,Bad Santa 2,24079268,17782178,6297090,2016.csv,2016,0.7384849904905747,0.2615150095094253
3606,Alien Adventure,24074680,8959784,15114896,1999.csv,1999,0.37216627593803947,0.6278337240619606
3607,Kung Fu Jungle,24070765,129784,23940981,2014.csv,2014,0.0053917688116684286,0.9946082311883315
3608,I Give My First Love to You,24051386,0,24051386,2009.csv,2009,0.0,1.0
3609,I Can Speak,24024444,63239,23961205,2017.csv,2017,0.0026322773588433514,0.9973677226411567
3610,Nasha Russia. Yaytsa sudby,24022125,0,24022125,2010.csv,2010,0.0,1.0
3611,Dark Water,24010000,0,24010000,2002.csv,2002,0.0,1.0
3612,Bring Happiness Home,23980000,0,23980000,2013.csv,2013,0.0,1.0
3613,Partner,23968620,1062840,22905780,2007.csv,2007,0.04434297844431594,0.9556570215556841
3614,I Want You,23961214,0,23961214,2012.csv,2012,0.0,1.0
3615,Türkisch für Anfänger,23952712,0,23952712,2012.csv,2012,0.0,1.0
3616,School for Scoundrels,23947685,17807569,6140116,2006.csv,2006,0.7436029411611185,0.25639705883888153
3617,I Love You in Every Language in the World,23941317,0,23941317,2005.csv,2005,0.0,1.0
3618,Stormbreaker,23937870,677646,23260224,2006.csv,2006,0.028308533716659,0.971691466283341
3619,Harold & Kumar Go to White Castle,23936908,18250550,5686358,2004.csv,2004,0.7624439213285191,0.23755607867148087
3620,Killing for the Prosecution,23929620,0,23929620,2018.csv,2018,0.0,1.0
3621,25th Hour,23928503,13084595,10843908,2002.csv,2002,0.5468204592656716,0.4531795407343284
3622,Birth,23925492,5095038,18830454,2004.csv,2004,0.21295436683182942,0.7870456331681706
3623,Mortadelo & Filemon: The Big Adventure,23920411,0,23920411,2003.csv,2003,0.0,1.0
3624,Sex Is Zero,23915279,0,23915279,2002.csv,2002,0.0,1.0
3625,Mao's Last Dancer,23914731,4817770,19096961,2009.csv,2009,0.20145616523974283,0.7985438347602571
3626,Life as a House,23903791,15667270,8236521,2001.csv,2001,0.6554303457556168,0.34456965424438324
3627,Pinocchio,23889592,1831718,22057874,2019.csv,2019,0.07667431072075237,0.9233256892792476
3628,Spirits' Homecoming,23857217,125616,23731601,2016.csv,2016,0.0052653249538703525,0.9947346750461297
3629,Silence,23834809,7100177,16734632,2016.csv,2016,0.2978910802264033,0.7021089197735967
3630,Lady Vengeance,23834149,211667,23622482,2005.csv,2005,0.00888082893163083,0.9911191710683692
3631,Eight Crazy Nights,23833131,23586598,246533,2002.csv,2002,0.9896558702253598,0.010344129774640184
3632,Wanderlust,23812816,17450535,6362281,2012.csv,2012,0.7328211413551425,0.26717885864485746
3633,Spencer,23807786,7086632,16721154,2021.csv,2021,0.2976602696277596,0.7023397303722404
3634,A Rainy Day in New York,23805899,0,23805899,2019.csv,2019,0.0,1.0
3635,Detective Conan: The Phantom of Baker Street,23786606,0,23786606,2002.csv,2002,0.0,1.0
3636,"Little Brother, Big Trouble: A Christmas Adventure",23785681,0,23785681,2012.csv,2012,0.0,1.0
3637,Dark Planet,23772559,0,23772559,2009.csv,2009,0.0,1.0
3638,Interstellar 2020 Re-release,23771122,0,23771122,2020.csv,2020,0.0,1.0
3639,Dickie Roberts: Former Child Star,23769505,22738671,1030834,2003.csv,2003,0.9566320796331266,0.04336792036687344
3640,Detroit Metal City,23744571,0,23744571,2008.csv,2008,0.0,1.0
3641,Pokémon the Movie: The Power of Us,23740788,789170,22951618,2018.csv,2018,0.0332411038757433,0.9667588961242567
3642,Russian Dolls,23727301,326095,23401206,2005.csv,2005,0.013743451056654105,0.9862565489433459
3643,In the Cut,23726793,4750602,18976191,2003.csv,2003,0.20022099067497237,0.7997790093250277
3644,The Peanut Butter Falcon,23712090,20457151,3254939,2019.csv,2019,0.862730826342174,0.13726917365782604
3645,Il mio miglior nemico,23710143,0,23710143,2006.csv,2006,0.0,1.0
3646,Da Xiao Jiang Hu,23705022,0,23705022,2010.csv,2010,0.0,1.0
3647,To the Arctic 3D,23695388,14560838,9134550,2012.csv,2012,0.6145009315736886,0.3854990684263115
3648,Anywhere But Here,23631929,18670401,4961528,1999.csv,1999,0.7900498093067223,0.20995019069327772
3649,Little White Lies 2,23623665,0,23623665,2019.csv,2019,0.0,1.0
3650,The Glass House,23619609,18150259,5469350,2001.csv,2001,0.7684402819707981,0.23155971802920192
3651,Kevin Hart: What Now?,23591043,23591043,0,2016.csv,2016,1.0,0.0
3652,Hustle & Flow,23563727,22202809,1360918,2005.csv,2005,0.9422452144348812,0.057754785565118795
3653,No manches Frida,23540937,11528613,12012324,2016.csv,2016,0.48972617360133114,0.5102738263986688
3654,Disco,23524551,0,23524551,2008.csv,2008,0.0,1.0
3655,Biker Boyz,23510621,22076772,1433849,2003.csv,2003,0.9390127125948736,0.06098728740512639
3656,Wish Upon,23468586,14301505,9167081,2017.csv,2017,0.6093892917110558,0.39061070828894423
3657,Those Who Wish Me Dead,23468586,7407200,16061386,2021.csv,2021,0.31562191262822564,0.6843780873717743
3658,Valley of the Wolves: Iraq,23465471,0,23465471,2006.csv,2006,0.0,1.0
3659,Tomcats,23430766,13558739,9872027,2001.csv,2001,0.5786724599614029,0.4213275400385971
3660,Act of Vengeance,23423390,0,23423390,2010.csv,2010,0.0,1.0
3661,Ossan's Love: Love or Dead,23422744,0,23422744,2019.csv,2019,0.0,1.0
3662,Only Cloud Knows,23410836,0,23410836,2019.csv,2019,0.0,1.0
3663,Kingdom Come,23396049,23249649,146400,2001.csv,2001,0.9937425331943868,0.006257466805613204
3664,In His Chart,23384864,0,23384864,2011.csv,2011,0.0,1.0
3665,Antwone Fisher,23367586,21078145,2289441,2002.csv,2002,0.9020249246113826,0.09797507538861738
3666,Detroit,23355100,16790139,6564961,2017.csv,2017,0.7189067484189748,0.2810932515810251
3667,Paris,23328518,1010194,22318324,2008.csv,2008,0.04330296506619066,0.9566970349338093
3668,Captain Alatriste: The Spanish Musketeer,23321954,0,23321954,2006.csv,2006,0.0,1.0
3669,Middle School: The Worst Years of My Life,23316139,20007149,3308990,2016.csv,2016,0.8580815631610362,0.14191843683896377
3670,Under the Same Moon,23313049,12590147,10722902,2008.csv,2008,0.5400472070384272,0.4599527929615727
3671,Warrior,23308615,13657115,9651500,2011.csv,2011,0.5859256330760108,0.41407436692398925
3672,Ali G Indahouse,23280529,0,23280529,2002.csv,2002,0.0,1.0
3673,Yomigaeri,23259542,0,23259542,2003.csv,2003,0.0,1.0
3674,"Sorry, If I Love You",23249815,0,23249815,2008.csv,2008,0.0,1.0
3675,Another Public Enemy,23248003,0,23248003,2005.csv,2005,0.0,1.0
3676,Jonas Brothers: The 3D Concert Experience,23186960,19162740,4024220,2009.csv,2009,0.8264446913265042,0.1735553086734958
3677,Super Troopers,23182223,18492362,4689861,2002.csv,2002,0.7976958033748532,0.2023041966251468
3678,Triple 9,23177948,12639297,10538651,2016.csv,2016,0.5453156163781194,0.4546843836218806
3679,Hoodwinked 2: Hood vs. Evil,23167844,10143779,13024065,2011.csv,2011,0.4378387130023838,0.5621612869976161
3680,The Iron Giant,23159305,23159305,0,1999.csv,1999,1.0,0.0
3681,Rock Dog,23157646,9420546,13737100,2016.csv,2016,0.40680067395451164,0.5931993260454884
3682,The Guernsey Literary and Potato Peel Pie Society,23148937,0,23148937,2018.csv,2018,0.0,1.0
3683,The Crimes That Bind,23144130,0,23144130,2018.csv,2018,0.0,1.0
3684,New Happy Dad and Son 3: Adventure in Russia,23130469,0,23130469,2018.csv,2018,0.0,1.0
3685,Dark Waters,23108017,11136084,11971933,2019.csv,2019,0.48191430705629135,0.5180856929437087
3686,Being John Malkovich,23106667,22863596,243071,1999.csv,1999,0.9894804819751806,0.010519518024819418
3687,The Confidence Man JP: Episode of the Hero,23100870,0,23100870,2022.csv,2022,0.0,1.0
3688,The Marksman,23076711,15566093,7510618,2021.csv,2021,0.6745368956607378,0.32546310433926223
3689,The Farewell,23076657,17695781,5380876,2019.csv,2019,0.7668260181706562,0.23317398182934382
3690,The Choice,23064015,18730891,4333124,2016.csv,2016,0.8121262061267304,0.1878737938732697
3691,"OSS 117: Cairo, Nest of Spies",23055884,303543,22752341,2006.csv,2006,0.013165532928600785,0.9868344670713992
3692,99.9 Criminal Lawyer: The Movie,23055069,0,23055069,2021.csv,2021,0.0,1.0
3693,Snow Falling on Cedars,23049593,14417593,8632000,1999.csv,1999,0.6255031487974647,0.37449685120253534
3694,"The Legend of Al, John and Jack",23039985,0,23039985,2002.csv,2002,0.0,1.0
3695,Confidence,23014206,12251640,10762566,2003.csv,2003,0.5323511921288964,0.46764880787110363
3696,Under the Hawthorn Tree,23004431,0,23004431,2010.csv,2010,0.0,1.0
3697,Buena Vista Social Club,23002182,7002182,16000000,1999.csv,1999,0.3044138160457995,0.6955861839542005
3698,Detective Conan: Full Score of Fear,22996756,0,22996756,2008.csv,2008,0.0,1.0
3699,Padmaavat,22991060,11846060,11145000,2018.csv,2018,0.5152463609768319,0.48475363902316815
3700,Aquamarine,22989957,18597342,4392615,2006.csv,2006,0.8089333094446414,0.19106669055535858
3701,Imagine That,22985194,16123323,6861871,2009.csv,2009,0.7014656043364264,0.2985343956635737
3702,Hotaru the Movie: It's Only a Little Light in My Life,22975341,0,22975341,2012.csv,2012,0.0,1.0
3703,Days of Glory,22963701,320700,22643001,2006.csv,2006,0.013965518885653493,0.9860344811143466
3704,Last Night in Soho,22957625,10127625,12830000,2021.csv,2021,0.4411442821284867,0.5588557178715132
3705,Penny Pincher!,22955486,0,22955486,2016.csv,2016,0.0,1.0
3706,The Human Stain,22954068,5381908,17572160,2003.csv,2003,0.23446423527193525,0.7655357647280647
3707,Kung Fu Dunk,22945567,0,22945567,2008.csv,2008,0.0,1.0
3708,Domino,22944502,10169202,12775300,2005.csv,2005,0.4432086606194373,0.5567913393805627
3709,Armored,22942221,15988876,6953345,2009.csv,2009,0.6969192738575747,0.30308072614242537
3710,Young Adult,22939027,16311571,6627456,2011.csv,2011,0.7110838223434673,0.28891617765653266
3711,A Perfect Getaway,22938329,15515460,7422869,2009.csv,2009,0.6763988780525382,0.3236011219474618
3712,Andalucia: Revenge of the Goddess,22929221,0,22929221,2011.csv,2011,0.0,1.0
3713,A Separation,22926076,7099055,15827021,2011.csv,2011,0.30964980662194436,0.6903501933780556
3714,Hot Road,22916313,0,22916313,2014.csv,2014,0.0,1.0
3715,The Wind that Shakes the Barley,22899908,1836089,21063819,2006.csv,2006,0.08017888106799381,0.9198211189320062
3716,Dorian Gray,22873653,0,22873653,2009.csv,2009,0.0,1.0
3717,The Merry Widow,22872698,0,22872698,2008.csv,2008,0.0,1.0
3718,Baggage Claim,22871096,21569509,1301587,2013.csv,2013,0.9430903092707057,0.056909690729294304
3719,Qualunquemente,22862029,0,22862029,2011.csv,2011,0.0,1.0
3720,Won't You Be My Neighbor?,22844741,22835787,8954,2018.csv,2018,0.9996080498351897,0.0003919501648103605
3721,Dr. T & the Women,22844291,13113041,9731250,2000.csv,2000,0.5740182962999377,0.42598170370006233
3722,Kon-Tiki,22842887,1517410,21325477,2012.csv,2012,0.06642811830220935,0.9335718816977907
3723,The Ruins,22818256,17432844,5385412,2008.csv,2008,0.763986695565165,0.23601330443483498
3724,Persepolis,22783978,4445756,18338222,2007.csv,2007,0.19512641734467967,0.8048735826553204
3725,The Knight of Shadows: Between Yin and Yang,22774256,0,22774256,2019.csv,2019,0.0,1.0
3726,Extraordinary Mission,22757764,54174,22703590,2017.csv,2017,0.0023804623336457836,0.9976195376663543
3727,Black and Blue,22741061,22055313,685748,2019.csv,2019,0.9698453823240701,0.030154617675929897
3728,U2,22730842,10363341,12367501,2008.csv,2008,0.4559154033977272,0.5440845966022728
3729,The Accidental Husband,22707064,0,22707064,2008.csv,2008,0.0,1.0
3730,Fading Gigolo,22706304,3769873,18936431,2014.csv,2014,0.1660275930420028,0.8339724069579972
3731,Cassandra's Dream,22686378,973018,21713360,2007.csv,2007,0.04288996683384188,0.9571100331661582
3732,Paco and the Magical Book,22679633,0,22679633,2008.csv,2008,0.0,1.0
3733,Christmas in Love,22668087,0,22668087,2004.csv,2004,0.0,1.0
3734,Fall in Love Like a Star,22640355,0,22640355,2012.csv,2012,0.0,1.0
3735,The White Massai,22632255,0,22632255,2005.csv,2005,0.0,1.0
3736,Detective Conan: Magician of the Silver Sky,22618511,0,22618511,2004.csv,2004,0.0,1.0
3737,EuroTrip,22605153,17771387,4833766,2004.csv,2004,0.7861653048753973,0.2138346951246028
3738,The Banquet,22598772,0,22598772,2006.csv,2006,0.0,1.0
3739,Drive Me Crazy,22593409,17845337,4748072,1999.csv,1999,0.7898470301670721,0.21015296983292783
3740,Recep Ivedik 3,22588876,0,22588876,2010.csv,2010,0.0,1.0
3741,Friends: Naki on the Monster Island,22537428,0,22537428,2011.csv,2011,0.0,1.0
3742,Asterix and the Vikings,22501596,0,22501596,2006.csv,2006,0.0,1.0
3743,The Day We Lit Up the Sky,22500000,0,22500000,2021.csv,2021,0.0,1.0
3744,Doomsday,22472631,11008770,11463861,2008.csv,2008,0.48987455006937103,0.5101254499306289
3745,The Last 10 Years,22456368,0,22456368,2022.csv,2022,0.0,1.0
3746,Swimming Pool,22441497,10130108,12311389,2003.csv,2003,0.45140072429214506,0.5485992757078549
3747,Europe Raiders,22435156,0,22435156,2018.csv,2018,0.0,1.0
3748,Men in the City,22420615,0,22420615,2009.csv,2009,0.0,1.0
3749,Villain,22414467,0,22414467,2010.csv,2010,0.0,1.0
3750,Two Can Play That Game,22391450,22235901,155549,2001.csv,2001,0.9930531966442548,0.006946803355745161
3751,Late Night,22386555,15499454,6887101,2019.csv,2019,0.6923554785450463,0.30764452145495363
3752,Dead Silence,22382047,16809076,5572971,2007.csv,2007,0.7510070906383138,0.24899290936168617
3753,Mojin: The Worm Valley,22381583,101516,22280067,2018.csv,2018,0.004535693476194244,0.9954643065238058
3754,At First Sight,22365133,22365133,0,1999.csv,1999,1.0,0.0
3755,The Contender,22361811,17872723,4489088,2000.csv,2000,0.7992520373238107,0.20074796267618933
3756,Les Misérables,22342519,330181,22012338,2019.csv,2019,0.01477814565134755,0.9852218543486525
3757,Muppets from Space,22323612,16625807,5697805,1999.csv,1999,0.7447633026411675,0.2552366973588324
3758,Kamen Rider OOO Wonderful: The Shogun and the 21 Core Medals,22313925,0,22313925,2011.csv,2011,0.0,1.0
3759,Quill: The Life of a Guide Dog,22298559,0,22298559,2004.csv,2004,0.0,1.0
3760,Chouchou,22288364,0,22288364,2003.csv,2003,0.0,1.0
3761,I've Loved You So Long,22272176,3169305,19102871,2008.csv,2008,0.1422988485723173,0.8577011514276827
3762,NASCAR: The IMAX Experience,22248831,21583831,665000,2004.csv,2004,0.970110789191576,0.029889210808424046
3763,Neuilly Yo Mama!,22243482,0,22243482,2009.csv,2009,0.0,1.0
3764,Reign Over Me,22242388,19661987,2580401,2007.csv,2007,0.8839872319464979,0.11601276805350216
3765,Waitress,22240529,19074800,3165729,2007.csv,2007,0.8576594558519719,0.14234054414802813
3766,A.R.O.G,22212369,0,22212369,2008.csv,2008,0.0,1.0
3767,Doraemon the Movie: Nobita's Little Star Wars 2021,22207831,0,22207831,2022.csv,2022,0.0,1.0
3768,Gooische vrouwen,22194574,0,22194574,2011.csv,2011,0.0,1.0
3769,Upside Down,22187813,105095,22082718,2012.csv,2012,0.004736609236791386,0.9952633907632086
3770,Fanaa,22175908,2105352,20070556,2006.csv,2006,0.09493870555379288,0.9050612944462071
3771,The Marine,22165608,18844784,3320824,2006.csv,2006,0.8501812357233783,0.1498187642766217
3772,Ghosts of the Abyss,22141539,17040871,5100668,2003.csv,2003,0.7696335381203628,0.2303664618796372
3773,Unbowed,22132903,0,22132903,2012.csv,2012,0.0,1.0
3774,Ip Man,22108789,0,22108789,2008.csv,2008,0.0,1.0
3775,The Glass Castle,22088533,17273059,4815474,2017.csv,2017,0.7819921313923383,0.21800786860766172
3776,Manual of Love,22079820,0,22079820,2005.csv,2005,0.0,1.0
3777,Stree,22075730,0,22075730,2018.csv,2018,0.0,1.0
3778,Gretel & Hansel,22051055,15347654,6703401,2020.csv,2020,0.6960054292186927,0.3039945707813073
3779,A Thousand Words,22044277,18450127,3594150,2010.csv,2010,0.8369576829396582,0.16304231706034178
3780,"Me, Them and Lara",22039646,0,22039646,2010.csv,2010,0.0,1.0
3781,Crows Zero,22036607,0,22036607,2007.csv,2007,0.0,1.0
3782,Little Black Book,22035509,20698668,1336841,2004.csv,2004,0.9393324202313639,0.06066757976863616
3783,Reno 911! Miami,22021262,20342161,1679101,2007.csv,2007,0.9237509185440871,0.07624908145591293
3784,My Blueberry Nights,22007671,867275,21140396,2007.csv,2007,0.039407850108264524,0.9605921498917355
3785,Parallel Mothers,21979001,2297501,19681500,2021.csv,2021,0.1045316390858711,0.8954683609141288
3786,Wild Child,21972336,0,21972336,2008.csv,2008,0.0,1.0
3787,Kaamelott: First Installment,21969341,188000,21781341,2021.csv,2021,0.008557380032473437,0.9914426199675266
3788,Love Don't Cost a Thing,21964072,21924226,39846,2003.csv,2003,0.9981858555189584,0.0018141444810415846
3789,Unaccompanied Minors,21949234,16655224,5294010,2006.csv,2006,0.7588066171238596,0.24119338287614045
3790,Leap! 2017 Re-release,21929861,21858070,71791,2017.csv,2017,0.9967263358395204,0.003273664160479631
3791,Moss,21925534,0,21925534,2010.csv,2010,0.0,1.0
3792,OSS 117: Lost in Rio,21924245,89375,21834870,2009.csv,2009,0.004076537185202957,0.995923462814797
3793,Unfair: The Movie,21914005,0,21914005,2007.csv,2007,0.0,1.0
3794,Like Stars on Earth,21897373,1223869,20673504,2007.csv,2007,0.05589113360767065,0.9441088663923294
3795,Flicka,21893591,21000147,893444,2006.csv,2006,0.9591915277854601,0.04080847221453986
3796,"Grande, grosso e... Verdone",21860130,0,21860130,2008.csv,2008,0.0,1.0
3797,The Immature,21858834,0,21858834,2011.csv,2011,0.0,1.0
3798,Do You Know Claudia?,21852972,0,21852972,2004.csv,2004,0.0,1.0
3799,Pleasant Goat and Big Big Wolf 3,21847806,0,21847806,2011.csv,2011,0.0,1.0
3800,Mr. 3000,21839377,21811187,28190,2004.csv,2004,0.9987092122637015,0.0012907877362985218
3801,Rob-B-Hood,21836580,0,21836580,2006.csv,2006,0.0,1.0
3802,Poupelle of Chimney Town,21831861,0,21831861,2020.csv,2020,0.0,1.0
3803,The Flight Before Christmas,21822495,0,21822495,2008.csv,2008,0.0,1.0
3804,The Barbarian Invasions 2003 Re-release,21815430,3435749,18379681,2003.csv,2003,0.1574916928064219,0.8425083071935782
3805,The Rebound,21791288,0,21791288,2009.csv,2009,0.0,1.0
3806,Phone,21784403,0,21784403,2002.csv,2002,0.0,1.0
3807,Torrente 3: El protector,21762391,0,21762391,2005.csv,2005,0.0,1.0
3808,Confession of Murder,21701525,0,21701525,2012.csv,2012,0.0,1.0
3809,22 Bullets,21695883,0,21695883,2010.csv,2010,0.0,1.0
3810,White Oleander,21672284,16357770,5314514,2002.csv,2002,0.7547783150128523,0.24522168498714764
3811,The Witch: Part 2. The Other One,21666635,143723,21522912,2022.csv,2022,0.00663337892570766,0.9933666210742923
3812,Inazuma Eleven GO the Movie: The Ultimate Bonds Gryphon,21645379,0,21645379,2010.csv,2010,0.0,1.0
3813,StreetDance 2 2012 Re-release,21638853,0,21638853,2012.csv,2012,0.0,1.0
3814,After We Fell,21610371,2170750,19439621,2021.csv,2021,0.10044945549523421,0.8995505445047658
3815,Father Stu,21587034,20884796,702238,2022.csv,2022,0.9674694541176894,0.03253054588231065
3816,Just Wright,21584424,21540363,44061,2010.csv,2010,0.9979586668608807,0.0020413331391192094
3817,Man of the House,21577624,19699706,1877918,2005.csv,2005,0.91296919438396,0.08703080561604003
3818,Wolfhound,21573338,0,21573338,2006.csv,2006,0.0,1.0
3819,Épouse-moi mon pote,21571464,0,21571464,2017.csv,2017,0.0,1.0
3820,Wicker Park,21568818,13001257,8567561,2004.csv,2004,0.6027802265288714,0.3972197734711286
3821,Quick,21561934,0,21561934,2011.csv,2011,0.0,1.0
3822,2012 2012 Re-release,21538353,0,21538353,2012.csv,2012,0.0,1.0
3823,Win a Date with Tad Hamilton!,21513434,17071962,4441472,2004.csv,2004,0.7935489053026124,0.20645109469738768
3824,Black Christmas,21510851,16273581,5237270,2006.csv,2006,0.7565289257965666,0.24347107420343342
3825,Let's Go! India,21505244,1120404,20384840,2007.csv,2007,0.052099106617902124,0.9479008933820978
3826,My Soul to Take,21500813,14744435,6756378,2010.csv,2010,0.6857617430559486,0.3142382569440514
3827,Winged Migration,21493351,924651,20568700,2001.csv,2001,0.04302032754222457,0.9569796724577754
3828,Over Her Dead Body,21458111,7563670,13894441,2008.csv,2008,0.35248536089686555,0.6475146391031344
3829,K-20: The Fiend with Twenty Faces,21443265,0,21443265,2008.csv,2008,0.0,1.0
3830,K-On! The Movie,21434003,0,21434003,2011.csv,2011,0.0,1.0
3831,The Merchant of Venice,21417725,3765585,17652140,2004.csv,2004,0.17581629234664278,0.8241837076533572
3832,Our Family Wedding,21409028,20255281,1153747,2010.csv,2010,0.9461093235993713,0.053890676400628744
3833,Crazy Romance,21386368,0,21386368,2019.csv,2019,0.0,1.0
3834,Year One in the North,21360942,0,21360942,2005.csv,2005,0.0,1.0
3835,Shaft,21360215,21360215,0,2019.csv,2019,1.0,0.0
3836,Unplanned,21354152,19005109,2349043,2019.csv,2019,0.8899959595679566,0.11000404043204338
3837,Waist Deep,21353303,21344312,8991,2006.csv,2006,0.9995789410191014,0.000421058980898646
3838,Rurouni Kenshin: Final Chapter Part II - The Beginning,21318560,0,21318560,2021.csv,2021,0.0,1.0
3839,Hotel Mumbai,21314816,9651611,11663205,2019.csv,2019,0.4528123067072219,0.5471876932927782
3840,Integrity,21290004,0,21290004,2019.csv,2019,0.0,1.0
3841,New York Minute,21289826,14071441,7218385,2004.csv,2004,0.6609467357788645,0.33905326422113546
3842,Arn: The Knight Templar,21287566,0,21287566,2007.csv,2007,0.0,1.0
3843,Stigmatized Properties,21276720,0,21276720,2020.csv,2020,0.0,1.0
3844,Michael Jordan to the Max,21268532,18650521,2618011,2000.csv,2000,0.8769068311813905,0.12309316881860957
3845,Astral City: A Spiritual Journey,21218935,0,21218935,2010.csv,2010,0.0,1.0
3846,The Prison,21205329,207481,20997848,2017.csv,2017,0.009784380143312088,0.9902156198566879
3847,Red Dog,21185162,0,21185162,2011.csv,2011,0.0,1.0
3848,ATL,21170563,21170563,0,2006.csv,2006,1.0,0.0
3849,Three Kingdoms,21159916,0,21159916,2008.csv,2008,0.0,1.0
3850,Penelope,21156270,10011996,11144274,2007.csv,2007,0.47324013164891543,0.5267598683510846
3851,Mindhunters,21148829,4480744,16668085,2004.csv,2004,0.2118672386069224,0.7881327613930776
3852,Stir of Echoes,21142914,21142914,0,1999.csv,1999,1.0,0.0
3853,The Jacket,21126225,6303762,14822463,2005.csv,2005,0.2983856320757731,0.7016143679242269
3854,Wish Dragon,21120000,0,21120000,2021.csv,2021,0.0,1.0
3855,Beasts of the Southern Wild,21107746,12795746,8312000,2012.csv,2012,0.6062109142302546,0.39378908576974536
3856,Pokémon the Movie: Secrets of the Jungle,21097921,0,21097921,2020.csv,2020,0.0,1.0
3857,The Secret Mission,21083522,0,21083522,2019.csv,2019,0.0,1.0
3858,My Girlfriend Is an Agent,21056256,0,21056256,2009.csv,2009,0.0,1.0
3859,Black Lightning,20984902,0,20984902,2009.csv,2009,0.0,1.0
3860,71: Into the Fire,20967660,176638,20791022,2010.csv,2010,0.008424306765752593,0.9915756932342474
3861,Once,20936722,9439923,11496799,2007.csv,2007,0.45087874787657783,0.5491212521234222
3862,Amores perros,20908467,5408467,15500000,2001.csv,2001,0.2586735316367288,0.7413264683632712
3863,The Devil's Rejects,20901859,17044981,3856878,2005.csv,2005,0.8154767956285611,0.18452320437143893
3864,Pokémon Heroes,20867919,746381,20121538,2002.csv,2002,0.035766910921975495,0.9642330890780245
3865,A Moment to Remember,20865847,0,20865847,2005.csv,2005,0.0,1.0
3866,G.O.R.A.,20839049,0,20839049,2004.csv,2004,0.0,1.0
3867,Vicky and the Treasure of the Gods,20796153,0,20796153,2011.csv,2011,0.0,1.0
3868,Love Aaj Kal,20794985,2430083,18364902,2009.csv,2009,0.11685908886205015,0.8831409111379499
3869,Le Grand Chef,20794760,0,20794760,2007.csv,2007,0.0,1.0
3870,Best in Show,20789556,18715392,2074164,2000.csv,2000,0.900230481112728,0.09976951888727205
3871,I Love You Phillip Morris,20768906,2037459,18731447,2009.csv,2009,0.09810141179318738,0.9018985882068127
3872,Pandemic,20712567,0,20712567,2009.csv,2009,0.0,1.0
3873,Bobby,20704591,11242801,9461790,2006.csv,2006,0.5430100502830507,0.45698994971694923
3874,The Photograph,20690779,20578185,112594,2020.csv,2020,0.9945582522533347,0.005441747746665314
3875,The Legend of 1900,20678716,167435,20511281,1999.csv,1999,0.008096972752079965,0.99190302724792
3876,Pandorum,20648328,10330853,10317475,2009.csv,2009,0.5003239487478115,0.49967605125218856
3877,Super Size Me,20645757,11536423,9109334,2004.csv,2004,0.5587793656585225,0.4412206343414775
3878,The Front Line,20629645,11018,20618627,2011.csv,2011,0.0005340857780150847,0.9994659142219849
3879,Polisse,20590872,211440,20379432,2011.csv,2011,0.010268627768653994,0.989731372231346
3880,Hollywoo,20587850,0,20587850,2011.csv,2011,0.0,1.0
3881,Walk Hard: The Dewey Cox Story,20576198,18317151,2259047,2007.csv,2007,0.8902106696290539,0.10978933037094608
3882,The 11 Commandments,20537839,0,20537839,2004.csv,2004,0.0,1.0
3883,Country Strong,20529194,20218921,310273,2010.csv,2010,0.9848862551544888,0.015113744845511227
3884,Yarn,20474270,0,20474270,2020.csv,2020,0.0,1.0
3885,One Hundred Thousand Bad Jokes 2,20460352,0,20460352,2017.csv,2017,0.0,1.0
3886,My Life in Ruins,20455482,8665206,11790276,2009.csv,2009,0.4236128975107993,0.5763871024892007
3887,Detective Conan: Jolly Roger in the Deep Azure,20440213,0,20440213,2007.csv,2007,0.0,1.0
3888,Doraemon: Nobita and the Wind Wizard,20428491,0,20428491,2003.csv,2003,0.0,1.0
3889,Beerfest,20387597,19185184,1202413,2006.csv,2006,0.9410223284284067,0.05897767157159326
3890,Ladies in Lavender,20377075,6765081,13611994,2004.csv,2004,0.3319947048337409,0.6680052951662592
3891,The Namesake,20354321,13569248,6785073,2007.csv,2007,0.6666519605345715,0.3333480394654285
3892,Violet Evergarden: The Movie,20339624,0,20339624,2020.csv,2020,0.0,1.0
3893,Brahms: The Boy II,20311536,12611536,7700000,2020.csv,2020,0.6209050856616654,0.37909491433833464
3894,Scabbard Samurai,20251745,0,20251745,2011.csv,2011,0.0,1.0
3895,Ong-Bak: The Thai Warrior,20235426,4563167,15672259,2003.csv,2003,0.22550387622182996,0.77449612377817
3896,Beck,20219060,0,20219060,2010.csv,2010,0.0,1.0
3897,How Not to Rescue a Princess,20157447,0,20157447,2010.csv,2010,0.0,1.0
3898,Serving Sara,20146150,16930185,3215965,2002.csv,2002,0.8403682589477394,0.1596317410522606
3899,Melinda and Melinda,20129327,3826280,16303047,2004.csv,2004,0.19008484486341745,0.8099151551365825
3900,Cado dalle nubi,20123466,0,20123466,2009.csv,2009,0.0,1.0
3901,Mulholland Drive,20117339,7220243,12897096,2001.csv,2001,0.35890646372266233,0.6410935362773377
3902,This Is Tomas,20084169,0,20084169,2019.csv,2019,0.0,1.0
3903,I Heart Huckabees,20072172,12785432,7286740,2004.csv,2004,0.6369730191630483,0.3630269808369518
3904,Evening,20016753,12492481,7524272,2007.csv,2007,0.6241012715698695,0.3758987284301305
3905,Asterix & Obelix: Mission Cleopatra 2002 Re-release,20015611,3115188,16900423,2002.csv,2002,0.155637916824023,0.8443620831759769
3906,The Divine Weapon,19991573,0,19991573,2008.csv,2008,0.0,1.0
3907,Kaiji 2: The Ultimate Gambler,19971259,0,19971259,2011.csv,2011,0.0,1.0
3908,About Her Brother,19969473,0,19969473,2010.csv,2010,0.0,1.0
3909,Himalaya 2001 Re-release,19960881,2487878,17473003,2001.csv,2001,0.12463768508013248,0.8753623149198675
3910,Crazy/Beautiful,19937988,16937988,3000000,2001.csv,2001,0.8495334634567941,0.15046653654320585
3911,Ballistic: Ecks vs. Sever,19924033,14307963,5616070,2002.csv,2002,0.7181258432968868,0.2818741567031133
3912,Get Over It,19900366,11576464,8323902,2001.csv,2001,0.5817211603042879,0.4182788396957121
3913,Turning Red,19894339,0,19894339,2022.csv,2022,0.0,1.0
3914,Jaane Tu,19852786,604037,19248749,2008.csv,2008,0.030425805224516097,0.9695741947754839
3915,Blindness,19844979,3351751,16493228,2008.csv,2008,0.1688966765850445,0.8311033234149555
3916,Lorelei,19806585,0,19806585,2005.csv,2005,0.0,1.0
3917,Trick the Movie: Psychic Battle Royale,19795115,0,19795115,2010.csv,2010,0.0,1.0
3918,Ice 2,19788995,0,19788995,2020.csv,2020,0.0,1.0
3919,The Diving Bell and the Butterfly,19780116,6003227,13776889,2007.csv,2007,0.3034980684643103,0.6965019315356897
3920,Two Days in Paris,19776159,4433994,15342165,2007.csv,2007,0.22420905899876714,0.7757909410012328
3921,Hello Ghost,19774455,0,19774455,2010.csv,2010,0.0,1.0
3922,Summer Catch,19772447,19753553,18894,2001.csv,2001,0.9990444278343494,0.0009555721656505136
3923,The Perfect Man,19770475,16535005,3235470,2005.csv,2005,0.8363483932480125,0.1636516067519875
3924,Stillwater,19754051,14465535,5288516,2021.csv,2021,0.7322819506743199,0.2677180493256801
3925,Thomas and the Magic Railroad,19748009,15933506,3814503,2000.csv,2000,0.8068411352253283,0.1931588647746717
3926,Another Year,19722766,3205706,16517060,2010.csv,2010,0.1625383579564854,0.8374616420435146
3927,Solomon Kane,19652185,0,19652185,2009.csv,2009,0.0,1.0
3928,Youth in Revolt,19651093,15281286,4369807,2010.csv,2010,0.7776303333356572,0.2223696666643428
3929,Amelia,19643086,14246488,5396598,2009.csv,2009,0.7252673027038623,0.2747326972961377
3930,Don,19640129,2223961,17416168,2006.csv,2006,0.11323555970533594,0.8867644402946641
3931,Shackleton's Antarctic Adventure,19613216,15553324,4059892,2001.csv,2001,0.7930022287013002,0.2069977712986998
3932,Drop,19611028,0,19611028,2009.csv,2009,0.0,1.0
3933,Movie: Marrying the Mafia 3 - Family Hustle,19606487,0,19606487,2006.csv,2006,0.0,1.0
3934,The Astronaut's Wife,19598588,10672566,8926022,1999.csv,1999,0.5445579038653193,0.45544209613468073
3935,The Wolf and the Lion,19585436,2072173,17513263,2021.csv,2021,0.10580172940750464,0.8941982705924953
3936,S1m0ne,19576023,9688676,9887347,2002.csv,2002,0.49492565471546496,0.5050743452845351
3937,Hot Summer Days,19573451,0,19573451,2010.csv,2010,0.0,1.0
3938,Soul Snatcher,19561221,0,19561221,2020.csv,2020,0.0,1.0
3939,View from the Top,19526014,15614000,3912014,2003.csv,2003,0.7996511730453537,0.20034882695464626
3940,Il cosmo sul comò,19494191,0,19494191,2008.csv,2008,0.0,1.0
3941,High Security Vacation,19487557,0,19487557,2009.csv,2009,0.0,1.0
3942,The Lion King 2002 IMAX Release,19486215,15686215,3800000,2002.csv,2002,0.8049903483051993,0.19500965169480067
3943,2046,19470239,1444588,18025651,2004.csv,2004,0.0741946721866126,0.9258053278133874
3944,Vanity Fair,19463185,16136476,3326709,2004.csv,2004,0.8290768443088836,0.17092315569111632
3945,Doug's 1st Movie,19440089,19440089,0,1999.csv,1999,1.0,0.0
3946,Buried,19439764,1044143,18395621,2010.csv,2010,0.05371171172654154,0.9462882882734585
3947,The Turning,19428166,15472775,3955391,2020.csv,2020,0.7964094500736714,0.2035905499263286
3948,Kamen Rider Decade: All Riders vs. Dai-Shocker,19418091,0,19418091,2009.csv,2009,0.0,1.0
3949,Get Carter,19412993,14967182,4445811,2000.csv,2000,0.7709878636436948,0.2290121363563053
3950,The Specials,19363826,0,19363826,2019.csv,2019,0.0,1.0
3951,Tuck Everlasting,19344615,19161999,182616,2002.csv,2002,0.9905598534786038,0.009440146521396265
3952,Rock Star,19334145,17008282,2325863,2001.csv,2001,0.8797017918299465,0.12029820817005354
3953,Ballad,19328678,0,19328678,2009.csv,2009,0.0,1.0
3954,Duplex,19322135,9692135,9630000,2003.csv,2003,0.5016078709728505,0.4983921290271494
3955,The White Ribbon,19319671,2222862,17096809,2009.csv,2009,0.115056928246863,0.884943071753137
3956,Celda 211,19300483,0,19300483,2009.csv,2009,0.0,1.0
3957,Deep Blue,19288261,132261,19156000,2003.csv,2003,0.006857072288683775,0.9931429277113162
3958,Summer of Sam,19288130,19288130,0,1999.csv,1999,1.0,0.0
3959,Mapado,19286223,0,19286223,2005.csv,2005,0.0,1.0
3960,O,19260537,16025437,3235100,2001.csv,2001,0.8320347973683184,0.16796520263168155
3961,Les Tuche 4,19259766,0,19259766,2021.csv,2021,0.0,1.0
3962,The Servant,19259164,0,19259164,2010.csv,2010,0.0,1.0
3963,Fate/Stay Night: Heaven's Feel - III. Spring Song,19252497,200000,19052497,2020.csv,2020,0.010388262883510644,0.9896117371164893
3964,Half Past Dead,19233280,15567860,3665420,2002.csv,2002,0.809423041727672,0.19057695827232796
3965,Windstruck,19225992,0,19225992,2004.csv,2004,0.0,1.0
3966,Martin Lawrence Live: Runteldat,19184820,19184820,0,2002.csv,2002,1.0,0.0
3967,Lyubov 2 Morkov,19171562,0,19171562,2008.csv,2008,0.0,1.0
3968,How to Lose Friends & Alienate People,19152009,2778752,16373257,2008.csv,2008,0.14508932196094937,0.8549106780390506
3969,The Weather Man,19126398,12482775,6643623,2005.csv,2005,0.6526464104741521,0.347353589525848
3970,Dear Evan Hansen,19123789,15002646,4121143,2021.csv,2021,0.7845017532874892,0.21549824671251078
3971,Norwegian Wood,19115721,13000,19102721,2010.csv,2010,0.000680068515333531,0.9993199314846665
3972,Bhool Bhulaiyaa,19073095,1097797,17975298,2007.csv,2007,0.05755736025013245,0.9424426397498675
3973,Always Miss You,19015465,91884,18923581,2019.csv,2019,0.0048320669518205316,0.9951679330481795
3974,A Mighty Heart,19008745,9176787,9831958,2007.csv,2007,0.4827665897985375,0.5172334102014625
3975,Akeelah and the Bee,18948425,18848430,99995,2006.csv,2006,0.9947227803893991,0.005277219610600881
3976,The Corsican File,18922216,0,18922216,2004.csv,2004,0.0,1.0
3977,The Man Who Wasn't There,18916623,7504257,11412366,2001.csv,2001,0.3967017263070687,0.6032982736929313
3978,The Curse of the Jade Scorpion,18914307,7517191,11397116,2001.csv,2001,0.3974341222229289,0.602565877777071
3979,Beast,18911959,0,18911959,2022.csv,2022,0.0,1.0
3980,Feardotcom,18902015,13258249,5643766,2002.csv,2002,0.7014198750768106,0.2985801249231894
3981,The Pioneer,18900000,0,18900000,2021.csv,2021,0.0,1.0
3982,The Green Knight,18888418,17173321,1715097,2021.csv,2021,0.9091984834304281,0.09080151656957189
3983,An Officer and a Spy,18878658,0,18878658,2019.csv,2019,0.0,1.0
3984,Head Over Heels,18876082,0,18876082,2010.csv,2010,0.0,1.0
3985,Taras Bulba,18874808,0,18874808,2009.csv,2009,0.0,1.0
3986,The Wild Guys 4,18873863,0,18873863,2007.csv,2007,0.0,1.0
3987,Antlers,18867659,10619670,8247989,2021.csv,2021,0.5628504309941154,0.43714956900588464
3988,Kitaro,18856642,0,18856642,2007.csv,2007,0.0,1.0
3989,The Counterfeiters,18814713,5488570,13326143,2007.csv,2007,0.291716913247627,0.708283086752373
3990,Sinkhole,18804231,0,18804231,2021.csv,2021,0.0,1.0
3991,Swing Girls,18758613,0,18758613,2004.csv,2004,0.0,1.0
3992,A Mighty Wind,18750246,17781006,969240,2003.csv,2003,0.948307878200638,0.051692121799361994
3993,Crayon Shin-chan: Honeymoon Hurricane - The Lost Hiroshi,18738951,0,18738951,2019.csv,2019,0.0,1.0
3994,Mobile Suit Gundam: Hathaway,18731309,0,18731309,2021.csv,2021,0.0,1.0
3995,Look at Me,18729751,1737308,16992443,2004.csv,2004,0.09275659884640218,0.9072434011535978
3996,Iznogoud- Caliph Instead of the Caliph,18725588,0,18725588,2005.csv,2005,0.0,1.0
3997,Detective Conan: Strategy Above the Depths,18723952,0,18723952,2005.csv,2005,0.0,1.0
3998,3000 Miles to Graceland,18720175,15749959,2970216,2001.csv,2001,0.8413360986208729,0.15866390137912706
3999,13 Assassins,18689058,802778,17886280,2010.csv,2010,0.042954438902164035,0.957045561097836
4000,The Ninth Gate,18661336,18661336,0,2000.csv,2000,1.0,0.0
4001,Greta,18653107,10532219,8120888,2019.csv,2019,0.56463617562479,0.43536382437521
4002,Waiting...,18637690,16124543,2513147,2005.csv,2005,0.8651578065736687,0.13484219342633127
4003,Max Keeble's Big Move,18634654,17294293,1340361,2001.csv,2001,0.9280715917773413,0.07192840822265871
4004,"Godzilla, Mothra and King Ghidorah: Giant Monsters All-Out Attack",18623382,0,18623382,2001.csv,2001,0.0,1.0
4005,An Unfinished Life,18618284,8586392,10031892,2005.csv,2005,0.46118063297347917,0.5388193670265208
4006,My Father and My Son,18612999,0,18612999,2005.csv,2005,0.0,1.0
4007,De-Lovely,18611951,13456633,5155318,2004.csv,2004,0.7230103388946167,0.2769896611053833
4008,Ho voglia di te,18594142,0,18594142,2007.csv,2007,0.0,1.0
4009,Empire,18591272,17600423,990849,2002.csv,2002,0.9467035391661205,0.05329646083387947
4010,Keeping Mum,18575768,1619466,16956302,2005.csv,2005,0.0871816443874622,0.9128183556125378
4011,See No Evil,18564467,15032800,3531667,2006.csv,2006,0.8097620039401078,0.19023799605989228
4012,The Thirteenth Floor,18564088,11916661,6647427,1999.csv,1999,0.6419200878599585,0.3580799121400416
4013,An Ideal Husband,18542974,18542974,0,1999.csv,1999,1.0,0.0
4014,Turetskiy gambit,18520000,0,18520000,2005.csv,2005,0.0,1.0
4015,Saawariya,18513120,885574,17627546,2007.csv,2007,0.04783494084195425,0.9521650591580457
4016,Green Zone 2010 Re-release,18495045,0,18495045,2010.csv,2010,0.0,1.0
4017,My Baby's Daddy,18490423,17669317,821106,2004.csv,2004,0.955592903418164,0.044407096581835906
4018,Hanbando,18483140,0,18483140,2006.csv,2006,0.0,1.0
4019,Loser,18404706,15618626,2786080,2000.csv,2000,0.848621325437092,0.151378674562908
4020,Bandidas,18381890,0,18381890,2006.csv,2006,0.0,1.0
4021,As It Is in Heaven,18318233,0,18318233,2005.csv,2005,0.0,1.0
4022,Bhool Bhulaiyaa 2,18307258,0,18307258,2022.csv,2022,0.0,1.0
4023,The World's Fastest Indian,18297690,5128124,13169566,2005.csv,2005,0.28026073236567023,0.7197392676343298
4024,Quai des illusions,18291248,0,18291248,2004.csv,2004,0.0,1.0
4025,Friends with Money,18245244,13368437,4876807,2006.csv,2006,0.7327080416134747,0.26729195838652525
4026,Daddy Day Camp,18197398,13235267,4962131,2007.csv,2007,0.7273164548030439,0.2726835451969562
4027,Antitrust,18195610,11328094,6867516,2001.csv,2001,0.6225729173135718,0.3774270826864282
4028,My Boss's Daughter,18191005,15550605,2640400,2003.csv,2003,0.8548513399891869,0.14514866001081303
4029,Voice of a Murderer,18160598,0,18160598,2007.csv,2007,0.0,1.0
4030,All the Pretty Horses,18133495,15540353,2593142,2000.csv,2000,0.8569971205219954,0.14300287947800466
4031,Takizawa Enbujo Zero,18091395,0,18091395,2020.csv,2020,0.0,1.0
4032,The Stronghold,18066143,0,18066143,2021.csv,2021,0.0,1.0
4033,Krrish,18041250,1430721,16610529,2006.csv,2006,0.07930276449802535,0.9206972355019747
4034,The Country Bears,18012097,16990825,1021272,2002.csv,2002,0.9433007716980427,0.05669922830195729
4035,Quills,17989227,7065332,10923895,2000.csv,2000,0.3927535074186345,0.6072464925813655
4036,Serial (Bad) Weddings 3,17979571,0,17979571,2022.csv,2022,0.0,1.0
4037,Night Watch 2005 Re-release,17939389,1502188,16437201,2005.csv,2005,0.08373685413700545,0.9162631458629945
4038,"Carry On, Munna Bhai",17897527,2217562,15679965,2006.csv,2006,0.12390326328324577,0.8760967367167543
4039,My Tutor Friend,17896209,0,17896209,2003.csv,2003,0.0,1.0
4040,Flyboys,17834865,13090630,4744235,2006.csv,2006,0.7339909777842445,0.2660090222157555
4041,The New World,17823920,0,17823920,2003.csv,2003,0.0,1.0
4042,Battle of the Warriors,17812601,0,17812601,2006.csv,2006,0.0,1.0
4043,Jail Breakers,17797711,0,17797711,2002.csv,2002,0.0,1.0
4044,The Rage: Carrie 2,17762705,17762705,0,1999.csv,1999,1.0,0.0
4045,The Last Kiss,17720347,1048950,16671397,2002.csv,2002,0.05919466475458974,0.9408053352454102
4046,The Promised Neverland,17710977,0,17710977,2020.csv,2020,0.0,1.0
4047,Joyeux Noel,17709155,1054361,16654794,2005.csv,2005,0.059537623336630124,0.9404623766633698
4048,Memories of Tomorrow,17696020,140200,17555820,2006.csv,2006,0.007922685440002894,0.9920773145599971
4049,Grave Decisions,17685834,0,17685834,2006.csv,2006,0.0,1.0
4050,You Are My Sunshine,17650142,0,17650142,2005.csv,2005,0.0,1.0
4051,Kaiji: Final Game,17645779,0,17645779,2020.csv,2020,0.0,1.0
4052,Palais royal!,17612135,0,17612135,2005.csv,2005,0.0,1.0
4053,Hitman: Agent Jun,17601351,0,17601351,2020.csv,2020,0.0,1.0
4054,Eye of the Beholder,17589705,16500786,1088919,1999.csv,1999,0.938093390423546,0.061906609576453955
4055,Orchestra Seats,17574836,2044858,15529978,2006.csv,2006,0.11635146979465413,0.8836485302053458
4056,Deliver Us from Eva,17573594,17573594,0,2003.csv,2003,1.0,0.0
4057,Roll Bounce,17500866,17380866,120000,2005.csv,2005,0.9931431964566781,0.006856803543321799
4058,Annapolis,17496992,17127992,369000,2006.csv,2006,0.9789106607581464,0.021089339241853685
4059,Rebound,17492014,16809014,683000,2005.csv,2005,0.9609536100302687,0.03904638996973133
4060,Bo Gia,17480489,350000,17130489,2021.csv,2021,0.020022323174140037,0.97997767682586
4061,"Paris, je t'aime",17471727,4899278,12572449,2006.csv,2006,0.2804117761226466,0.7195882238773534
4062,A Guy Thing,17432163,15545431,1886732,2003.csv,2003,0.8917671891893163,0.10823281081068367
4063,The Dry,17424378,364237,17060141,2021.csv,2021,0.020903873871423128,0.9790961261285769
4064,Frailty,17423030,13110448,4312582,2002.csv,2002,0.7524780706914929,0.2475219293085072
4065,Stormy Night,17379776,0,17379776,2005.csv,2005,0.0,1.0
4066,The Matador,17347231,12594698,4752533,2005.csv,2005,0.7260350657692862,0.27396493423071383
4067,Digimon Adventure: Last Evolution Kizuna,17337522,0,17337522,2020.csv,2020,0.0,1.0
4068,Would I Lie to You? 2,17317084,0,17317084,2003.csv,2003,0.0,1.0
4069,The Importance of Being Earnest,17290970,8384929,8906041,2002.csv,2002,0.4849310940913089,0.515068905908691
4070,Gintama: The Final,17252960,0,17252960,2021.csv,2021,0.0,1.0
4071,Railway Heroes,17223542,0,17223542,2021.csv,2021,0.0,1.0
4072,Promising Young Woman,17202213,6460965,10741248,2020.csv,2020,0.37558917564850525,0.6244108243514948
4073,Kinsey,17050017,10254979,6795038,2004.csv,2004,0.6014644442876509,0.39853555571234917
4074,Kung Pow: Enter the Fist,16994625,16037962,956663,2002.csv,2002,0.9437079076472709,0.056292092352729174
4075,Dead Weight,16987957,0,16987957,2002.csv,2002,0.0,1.0
4076,Legend No. 17,16977165,0,16977165,2021.csv,2021,0.0,1.0
4077,Bye Bye Morons,16955924,0,16955924,2020.csv,2020,0.0,1.0
4078,Jason X,16951798,13121555,3830243,2001.csv,2001,0.7740509295828089,0.22594907041719114
4079,Catch That Kid,16951702,16703799,247903,2004.csv,2004,0.9853759227244556,0.014624077275544368
4080,Sugar & Spice,16908947,13305101,3603846,2001.csv,2001,0.7868675086627216,0.21313249133727843
4081,Material Girls,16907725,11449638,5458087,2006.csv,2006,0.677183831650917,0.32281616834908305
4082,Zhara,16877870,0,16877870,2006.csv,2006,0.0,1.0
4083,Life or Something Like It,16872671,14448589,2424082,2002.csv,2002,0.8563308678276249,0.1436691321723751
4084,Aegis,16869261,0,16869261,2005.csv,2005,0.0,1.0
4085,The Good Girl,16856124,14018296,2837828,2002.csv,2002,0.8316440956414417,0.16835590435855835
4086,Femme Fatale,16838910,6630252,10208658,2002.csv,2002,0.3937459134825235,0.6062540865174765
4087,House of 1000 Corpses,16829545,12634962,4194583,2003.csv,2003,0.7507607603176437,0.24923923968235623
4088,Bringing Out the Dead,16797191,16797191,0,1999.csv,1999,1.0,0.0
4089,Paparazzi,16796512,15714234,1082278,2004.csv,2004,0.9355653126077604,0.06443468739223954
4090,House of Sand and Fog,16763804,13040288,3723516,2003.csv,2003,0.7778835877584825,0.22211641224151749
4091,Baaghi 3,16726510,721439,16005071,2020.csv,2020,0.043131472136147944,0.956868527863852
4092,Dogville,16680836,1535286,15145550,2003.csv,2003,0.0920389121984054,0.9079610878015946
4093,CyberWorld,16653900,11253900,5400000,2000.csv,2000,0.6757516257453209,0.32424837425467906
4094,Extreme,16653175,12475172,4178003,1999.csv,1999,0.7491167299929293,0.2508832700070707
4095,True Crime,16649768,16649768,0,1999.csv,1999,1.0,0.0
4096,Digimon: The Movie,16643191,9631153,7012038,2000.csv,2000,0.5786842799556888,0.4213157200443112
4097,The Dish,16575074,2552992,14022082,2000.csv,2000,0.1540259790092038,0.8459740209907962
4098,Your Turn to Kill,16511822,0,16511822,2021.csv,2021,0.0,1.0
4099,Cry Macho,16481544,10310734,6170810,2021.csv,2021,0.6255927235943428,0.37440727640565713
4100,They,16446271,12840842,3605429,2002.csv,2002,0.7807752894257914,0.2192247105742086
4101,Reminiscence,16430773,3900193,12530580,2021.csv,2021,0.2373712423633386,0.7626287576366614
4102,The Powerpuff Girls Movie,16426471,11412414,5014057,2002.csv,2002,0.6947575045181646,0.3052424954818354
4103,The Magdalene Sisters,16373112,306989,16066123,2002.csv,2002,0.018749581631152343,0.9812504183688476
4104,One Missed Call,16367880,0,16367880,2004.csv,2004,0.0,1.0
4105,"Nin x Nin: Ninja Hattori-kun, the Movie",16351134,0,16351134,2004.csv,2004,0.0,1.0
4106,Italian for Beginners,16349568,4544753,11804815,2000.csv,2000,0.27797388897370257,0.7220261110262974
4107,The Emperor's Club,16318449,14118751,2199698,2002.csv,2002,0.865201772545908,0.13479822745409198
4108,Rabbit-Proof Fence,16217411,6199600,10017811,2002.csv,2002,0.38228050087649623,0.6177194991235038
4109,Caché (Hidden),16197824,3647381,12550443,2005.csv,2005,0.22517722133540902,0.774822778664591
4110,Just Visiting,16176732,4781539,11395193,2001.csv,2001,0.2955812706793931,0.7044187293206069
4111,Birthday Girl,16171098,5142576,11028522,2002.csv,2002,0.31801031692467635,0.6819896830753236
4112,Iris,16153953,5594617,10559336,2001.csv,2001,0.3463311426002044,0.6536688573997956
4113,A Midsummer Night's Dream,16071990,16071990,0,1999.csv,1999,1.0,0.0
4114,I Still Believe,16069730,9868521,6201209,2020.csv,2020,0.6141062108697533,0.38589378913024674
4115,To Be and to Have,16063920,777129,15286791,2002.csv,2002,0.04837729520565341,0.9516227047943466
4116,Doraemon: Nobita and the Robot Kingdom,16053687,0,16053687,2002.csv,2002,0.0,1.0
4117,What the #$*! Do We (K)now!?,15998178,10942306,5055872,2004.csv,2004,0.6839720123129022,0.3160279876870979
4118,Upon the Magic Roads,15990882,0,15990882,2021.csv,2021,0.0,1.0
4119,Radhe Shyam,15954804,1860000,14094804,2022.csv,2022,0.11657930739857413,0.8834206926014259
4120,Freaky,15920855,9030855,6890000,2020.csv,2020,0.5672342974042537,0.43276570259574626
4121,Drowning Mona,15906764,15506764,400000,2000.csv,2000,0.974853464853065,0.025146535146934976
4122,Public Enemy,15897574,0,15897574,2002.csv,2002,0.0,1.0
4123,Before Sunset,15849759,5820649,10029110,2004.csv,2004,0.3672389592800749,0.6327610407199251
4124,Highlander: Endgame,15843608,12811858,3031750,2000.csv,2000,0.8086452277789251,0.1913547722210749
4125,Lucky Luke and the Daltons,15823762,0,15823762,2004.csv,2004,0.0,1.0
4126,The Great Yokai War,15787492,0,15787492,2005.csv,2005,0.0,1.0
4127,Kiss Kiss Bang Bang,15785148,4243756,11541392,2005.csv,2005,0.26884486607284264,0.7311551339271574
4128,The Gospel,15778152,15778152,0,2005.csv,2005,1.0,0.0
4129,Lantana,15747450,4623189,11124261,2001.csv,2001,0.2935833420649058,0.7064166579350942
4130,Enigma 2001 Re-release,15705007,4301582,11403425,2001.csv,2001,0.27389876362360105,0.7261012363763989
4131,Wunderschön,15603848,0,15603848,2022.csv,2022,0.0,1.0
4132,Facing Windows,15530077,543354,14986723,2003.csv,2003,0.03498720579427906,0.965012794205721
4133,Maison de retraite,15512671,0,15512671,2022.csv,2022,0.0,1.0
4134,Two Sons of Francisco,15508288,0,15508288,2005.csv,2005,0.0,1.0
4135,The Way Back,15480704,13590514,1890190,2020.csv,2020,0.8779002556989657,0.12209974430103437
4136,With a Friend Like Harry...,15472186,3830441,11641745,2001.csv,2001,0.24756947725421605,0.7524305227457839
4137,Bait,15471969,15325127,146842,2000.csv,2000,0.9905091588536663,0.009490841146333735
4138,Operation Mincemeat,15466867,0,15466867,2022.csv,2022,0.0,1.0
4139,Zelary,15461305,330033,15131272,2003.csv,2003,0.02134574022050532,0.9786542597794947
4140,The Night House,15437703,7100581,8337122,2021.csv,2021,0.45995061571012213,0.5400493842898778
4141,The Greatest Game Ever Played,15431177,15337393,93784,2005.csv,2005,0.9939224337845389,0.006077566215461076
4142,Blacklight,15412319,9591094,5821225,2022.csv,2022,0.6223005116880853,0.37769948831191463
4143,Padre no hay más que uno 2: La llegada de la suegra,15373181,0,15373181,2020.csv,2020,0.0,1.0
4144,Harry Potter and the Sorcerer's Stone 2021 Re-release,15372357,799342,14573015,2021.csv,2021,0.0519986622741067,0.9480013377258933
4145,Alex & Emma,15368897,14218698,1150199,2003.csv,2003,0.9251606019612207,0.07483939803877923
4146,Drive My Car,15334331,2352240,12982091,2021.csv,2021,0.15339697571416713,0.8466030242858329
4147,Minari,15312445,3110580,12201865,2021.csv,2021,0.20314064801538878,0.7968593519846112
4148,Brother,15250594,450594,14800000,2001.csv,2001,0.029545996700194106,0.9704540032998059
4149,Hey Arnold! The Movie,15249308,13728902,1520406,2002.csv,2002,0.9002967216610748,0.09970327833892528
4150,Bheemla Nayak,15243922,0,15243922,2022.csv,2022,0.0,1.0
4151,Something About Love,15204017,0,15204017,2021.csv,2021,0.0,1.0
4152,Transamerica,15151744,9015303,6136441,2005.csv,2005,0.5950010111047283,0.40499898889527175
4153,Surviving Christmas,15125687,11663156,3462531,2004.csv,2004,0.7710827283415292,0.22891727165847078
4154,The Dreamers,15121165,2532228,12588937,2003.csv,2003,0.1674624937959476,0.8325375062040524
4155,Anita,15026604,556632,14469972,2021.csv,2021,0.03704310035720646,0.9629568996427935
4156,Boat Trip,15020293,8600126,6420167,2002.csv,2002,0.5725671263536604,0.42743287364633964
4157,Oldboy,14980005,707481,14272524,2003.csv,2003,0.0472283553977452,0.9527716446022548
4158,Undisputed,14946150,12764657,2181493,2002.csv,2002,0.8540431482354988,0.14595685176450124
4159,"Murder, Take One",14915208,0,14915208,2005.csv,2005,0.0,1.0
4160,The Last Trapper,14905929,0,14905929,2004.csv,2004,0.0,1.0
4161,Election,14902041,14902041,0,1999.csv,1999,1.0,0.0
4162,Battle Royale II,14899584,0,14899584,2003.csv,2003,0.0,1.0
4163,Firestarter,14889250,9589250,5300000,2022.csv,2022,0.6440384841412429,0.3559615158587572
4164,Raise Your Voice,14867514,10411980,4455534,2004.csv,2004,0.7003174841469798,0.2996825158530202
4165,Josie and the Pussycats,14866015,14271015,595000,2001.csv,2001,0.9599758240523771,0.040024175947622816
4166,Music of the Heart,14859394,14859394,0,1999.csv,1999,1.0,0.0
4167,Supernova,14828081,14230455,597626,2000.csv,2000,0.9596963356215817,0.040303664378418216
4168,Soul Plane,14821824,14190750,631074,2004.csv,2004,0.9574226491962123,0.04257735080378771
4169,One Piece: Dead End Adventure,14817006,0,14817006,2003.csv,2003,0.0,1.0
4170,Possession,14815898,10113733,4702165,2002.csv,2002,0.6826270672219801,0.3173729327780199
4171,Out Cold,14782676,13906394,876282,2001.csv,2001,0.940722369887563,0.059277630112437016
4172,The Triplets of Belleville,14776760,7007149,7769611,2003.csv,2003,0.47420063667542817,0.5257993633245718
4173,Super-héros malgré lui,14771200,0,14771200,2022.csv,2022,0.0,1.0
4174,Most Beautiful Week in My Life,14765033,0,14765033,2005.csv,2005,0.0,1.0
4175,Iron Monkey,14694904,14694904,0,2001.csv,2001,1.0,0.0
4176,Together with You,14687167,1151941,13535226,2003.csv,2003,0.07843180376447002,0.92156819623553
4177,Samurai Commando Mission 1549,14648713,0,14648713,2005.csv,2005,0.0,1.0
4178,Half a Confession,14638660,0,14638660,2004.csv,2004,0.0,1.0
4179,Welcome to Mooseport,14615099,14470947,144152,2004.csv,2004,0.9901367756728846,0.009863224327115403
4180,Crayon Shin-chan: Mononoke Ninja Chinpuden,14609977,0,14609977,2022.csv,2022,0.0,1.0
4181,Together,14572229,1034829,13537400,2001.csv,2001,0.07101377558642538,0.9289862244135746
4182,Hollywood Ending,14569744,4850753,9718991,2002.csv,2002,0.33293330342660793,0.6670666965733921
4183,Envy,14494036,13562325,931711,2004.csv,2004,0.9357176289613189,0.06428237103868101
4184,Malena,14493284,3448233,11045051,2000.csv,2000,0.23791937010273173,0.7620806298972683
4185,Tea with Mussolini,14401563,14401563,0,1999.csv,1999,1.0,0.0
4186,I Dreamed of Africa,14400327,6651522,7748805,2000.csv,2000,0.4619007610035522,0.5380992389964477
4187,The Tomorrow War,14400000,0,14400000,2021.csv,2021,0.0,1.0
4188,The Personal History of David Copperfield,14399270,1876298,12522972,2020.csv,2020,0.130305077965758,0.869694922034242
4189,How to Deal,14390329,14195227,195102,2003.csv,2003,0.986442144581962,0.013557855418038044
4190,And So the Baton Is Passed,14368469,0,14368469,2021.csv,2021,0.0,1.0
4191,Being Julia,14339171,7739049,6600122,2004.csv,2004,0.5397138370133113,0.4602861629866887
4192,Freddy Got Fingered,14333252,14254993,78259,2001.csv,2001,0.9945400387853364,0.005459961214663637
4193,Nightlife,14308789,0,14308789,2020.csv,2020,0.0,1.0
4194,Stealing Harvard,14277032,14036406,240626,2002.csv,2002,0.9831459367745341,0.01685406322546591
4195,Blood Rain,14270938,0,14270938,2005.csv,2005,0.0,1.0
4196,X,14257609,11765309,2492300,2022.csv,2022,0.8251950940722249,0.17480490592777512
4197,The Duke,14213589,1520977,12692612,2022.csv,2022,0.10700865207232318,0.8929913479276769
4198,Sarkaru Vaari Paata,14199018,0,14199018,2022.csv,2022,0.0,1.0
4199,Pawn,14193957,0,14193957,2020.csv,2020,0.0,1.0
4200,Proof,14189860,7535331,6654529,2005.csv,2005,0.5310363174830478,0.46896368251695225
4201,What Planet Are You From?,14145677,6291602,7854075,2000.csv,2000,0.4447720671128006,0.5552279328871994
4202,Godzilla Against MechaGodzilla,14122958,0,14122958,2002.csv,2002,0.0,1.0
4203,Football Days,14117202,0,14117202,2003.csv,2003,0.0,1.0
4204,Crayon Shin-chan: Shrouded in Mystery! The Flowers of Tenkasu Academy,14059824,0,14059824,2021.csv,2021,0.0,1.0
4205,The Quintessential Quintuplets Movie,14045207,0,14045207,2022.csv,2022,0.0,1.0
4206,Sword Art Online: Progressive - Aria of a Starless Night,14037060,1050000,12987060,2021.csv,2021,0.07480198845057298,0.925198011549427
4207,Osmosis Jones,14026418,13596911,429507,2001.csv,2001,0.9693787109438775,0.030621289056122526
4208,In Too Deep,14011454,14011454,0,1999.csv,1999,1.0,0.0
4209,Ghosts of Mars,14010832,8709640,5301192,2001.csv,2001,0.621636174068749,0.3783638259312509
4210,Vizontele Tuuba,13954476,0,13954476,2004.csv,2004,0.0,1.0
4211,Idiots,13936317,0,13936317,2002.csv,2002,0.0,1.0
4212,Dirty Pretty Things,13904766,8112414,5792352,2002.csv,2002,0.5834268624153761,0.4165731375846239
4213,Touching the Void,13885802,4593598,9292204,2003.csv,2003,0.33081258108102074,0.6691874189189793
4214,French Spies,13844465,0,13844465,2004.csv,2004,0.0,1.0
4215,House of the Dead,13818181,10249719,3568462,2003.csv,2003,0.7417560241829225,0.25824397581707753
4216,Juwanna Mann,13802599,13670733,131866,2002.csv,2002,0.9904462920352899,0.009553707964710124
4217,The Ladies Man,13743212,13616610,126602,2000.csv,2000,0.9907880341218632,0.009211965878136785
4218,Christmas with the Chosen: The Messengers,13728000,13728000,0,2021.csv,2021,1.0,0.0
4219,American Outlaws,13678913,13342790,336123,2001.csv,2001,0.9754276527674385,0.024572347232561534
4220,Broker,13634553,0,13634553,2022.csv,2022,0.0,1.0
4221,Der Wixxer,13607165,0,13607165,2004.csv,2004,0.0,1.0
4222,Eiffel,13598267,438823,13159444,2021.csv,2021,0.0322705091759119,0.9677294908240881
4223,Anything Else,13585075,3212310,10372765,2003.csv,2003,0.23645876080919687,0.7635412391908032
4224,One Night at McCool's,13473370,6290673,7182697,2001.csv,2001,0.46689677489744585,0.5331032251025541
4225,OSS 117: From Africa with Love,13447941,0,13447941,2021.csv,2021,0.0,1.0
4226,School of Magical Animals,13441618,0,13441618,2021.csv,2021,0.0,1.0
4227,#Alive,13432212,0,13432212,2020.csv,2020,0.0,1.0
4228,One Piece: The Cursed Holy Sword,13422333,0,13422333,2004.csv,2004,0.0,1.0
4229,Trapped,13414416,7073251,6341165,2002.csv,2002,0.5272872855590582,0.47271271444094176
4230,Solarmax,13400161,13400161,0,2000.csv,2000,1.0,0.0
4231,Howling Village,13394556,0,13394556,2020.csv,2020,0.0,1.0
4232,Umizaru,13361623,0,13361623,2004.csv,2004,0.0,1.0
4233,RRRrrrr!!!,13315054,54361,13260693,2004.csv,2004,0.004082672139369469,0.9959173278606306
4234,Valimai,13276393,0,13276393,2022.csv,2022,0.0,1.0
4235,Vera Drake,13267869,3775283,9492586,2004.csv,2004,0.2845432827230959,0.7154567172769041
4236,The Mod Squad,13263993,13263993,0,1999.csv,1999,1.0,0.0
4237,Vidocq,13240767,0,13240767,2001.csv,2001,0.0,1.0
4238,Kal Ho Naa Ho,13200241,1991922,11208319,2003.csv,2003,0.15090042674220872,0.8490995732577913
4239,Come Play,13182254,10475990,2706264,2020.csv,2020,0.7947040013035707,0.2052959986964293
4240,Head Over Heels,13127022,10424470,2702552,2001.csv,2001,0.7941229930139524,0.20587700698604755
4241,Hostage: Missing Celebrity,13125970,0,13125970,2021.csv,2021,0.0,1.0
4242,Toei Spring Anime Fair,13107237,0,13107237,2002.csv,2002,0.0,1.0
4243,The Crew,13105853,13023075,82778,2000.csv,2000,0.9936838907013531,0.006316109298646948
4244,Long Time Dead,13102295,0,13102295,2002.csv,2002,0.0,1.0
4245,The Way of the Gun,13069740,6055661,7014079,2000.csv,2000,0.4633344657200526,0.5366655342799475
4246,The Barbarian Invasions,13065317,5109226,7956091,2003.csv,2003,0.39105258601838744,0.6089474139816126
4247,The Many Saints of Newark,13058293,8237403,4820890,2021.csv,2021,0.6308177493030674,0.3691822506969326
4248,Vakeel Saab,13056490,0,13056490,2021.csv,2021,0.0,1.0
4249,Angela's Ashes,13042112,13042112,0,1999.csv,1999,1.0,0.0
4250,Onmyoji 2,13022862,0,13022862,2003.csv,2003,0.0,1.0
4251,Monkey King Reborn,13002635,0,13002635,2021.csv,2021,0.0,1.0
4252,The Divorce,12991996,9081057,3910939,2003.csv,2003,0.6989731985754922,0.30102680142450783
4253,Mariages!,12991310,0,12991310,2004.csv,2004,0.0,1.0
4254,Gods and Generals,12923936,12882934,41002,2003.csv,2003,0.9968274370903725,0.0031725629096275316
4255,No Escapes,12916151,0,12916151,2021.csv,2021,0.0,1.0
4256,Sun Alley,12891924,0,12891924,1999.csv,1999,0.0,1.0
4257,Formula 51,12881605,5204007,7677598,2001.csv,2001,0.4039874689528207,0.5960125310471793
4258,The Bodin's in the Land of Smile,12872253,0,12872253,2021.csv,2021,0.0,1.0
4259,In the Mood for Love,12854953,2738980,10115973,2000.csv,2000,0.21306806800460493,0.7869319319953951
4260,The Girl from Paris,12812396,183266,12629130,2001.csv,2001,0.014303803909901006,0.985696196090099
4261,Knockaround Guys,12806614,11715637,1090977,2002.csv,2002,0.9148114404010302,0.08518855959896972
4262,Bergen,12798854,0,12798854,2022.csv,2022,0.0,1.0
4263,Samjin Company English Class,12761386,0,12761386,2020.csv,2020,0.0,1.0
4264,Another Round,12741800,0,12741800,2020.csv,2020,0.0,1.0
4265,"Remember Me, My Love",12671306,227986,12443320,2003.csv,2003,0.01799230481846149,0.9820076951815385
4266,News of the World,12668325,12668325,0,2020.csv,2020,1.0,0.0
4267,Memory,12661392,7329043,5332349,2022.csv,2022,0.5788497030974161,0.4211502969025839
4268,Chasing Papi,12661189,6130049,6531140,2003.csv,2003,0.4841606108241493,0.5158393891758507
4269,Collectors,12640113,0,12640113,2020.csv,2020,0.0,1.0
4270,Winged Migration 2003 Re-release,12634963,10764402,1870561,2003.csv,2003,0.8519535830852849,0.14804641691471515
4271,Narc,12633747,10465659,2168088,2002.csv,2002,0.8283891548564333,0.17161084514356667
4272,The Other Side of the Bed,12630208,0,12630208,2002.csv,2002,0.0,1.0
4273,The Omega Code,12614346,12614346,0,1999.csv,1999,1.0,0.0
4274,Maria Full of Grace,12594630,6529624,6065006,2004.csv,2004,0.5184450833410748,0.48155491665892525
4275,Gossip,12591270,5108820,7482450,2000.csv,2000,0.4057430267161295,0.5942569732838705
4276,Character,12571501,0,12571501,2021.csv,2021,0.0,1.0
4277,Breakin' All the Rules,12544254,12264319,279935,2004.csv,2004,0.9776842050551591,0.022315794944840883
4278,Apocalypse Now Redux,12543269,4626290,7916979,2001.csv,2001,0.36882649969477654,0.6311735003052235
4279,The Clearing,12520799,5763875,6756924,2004.csv,2004,0.46034402437096866,0.5396559756290313
4280,Sorority Boys,12517488,10200032,2317456,2002.csv,2002,0.8148625347194262,0.18513746528057387
4281,Black Mask,12504289,12504289,0,1999.csv,1999,1.0,0.0
4282,Seducing Doctor Lewis,12504038,9354342,3149696,2003.csv,2003,0.7481056919372766,0.2518943080627234
4283,Ready to Rumble,12452362,12394327,58035,2000.csv,2000,0.9953394384133709,0.004660561586629107
4284,Nine Queens,12413888,1222889,11190999,2002.csv,2002,0.09850974972546876,0.9014902502745312
4285,Monsieur Ibrahim,12364836,2823890,9540946,2003.csv,2003,0.22838070800130306,0.7716192919986969
4286,Casshern,12353768,0,12353768,2004.csv,2004,0.0,1.0
4287,Say It Isn't So,12320393,5520393,6800000,2001.csv,2001,0.4480695542747703,0.5519304457252298
4288,Chasing Liberty,12313323,12195626,117697,2004.csv,2004,0.990441491707803,0.009558508292196996
4289,Abandon,12302219,10727683,1574536,2002.csv,2002,0.8720120329511286,0.12798796704887141
4290,Shinchan: Crash! Scribble Kingdom and Almost Four Heroes,12221804,0,12221804,2020.csv,2020,0.0,1.0
4291,Koi... Mil Gaya,12168232,671372,11496860,2003.csv,2003,0.05517416170237385,0.9448258382976261
4292,The Eye,12165016,512049,11652967,2002.csv,2002,0.04209192984209803,0.957908070157902
4293,Ducobu 3,12157793,0,12157793,2020.csv,2020,0.0,1.0
4294,Dark Blue,12150301,9250301,2900000,2003.csv,2003,0.7613227853367583,0.23867721466324168
4295,The Worst Person in the World,12134807,3034775,9100032,2021.csv,2021,0.25008844392828,0.74991155607172
4296,Dragon Ball Super: Super Hero,12121600,0,12121600,2022.csv,2022,0.0,1.0
4297,On Your Mark,12100000,0,12100000,2021.csv,2021,0.0,1.0
4298,Don't Move,12071007,337265,11733742,2004.csv,2004,0.027940088179884248,0.9720599118201158
4299,Kureyon Shin-chan 2004 Re-release,12066375,0,12066375,2004.csv,2004,0.0,1.0
4300,2009: Lost Memories,12049825,0,12049825,2002.csv,2002,0.0,1.0
4301,In Dreams,12017369,12017369,0,1999.csv,1999,1.0,0.0
4302,The Cookout,12009070,11814019,195051,2004.csv,2004,0.9837580262251782,0.016241973774821863
4303,The King and I,11993021,11993021,0,1999.csv,1999,1.0,0.0
4304,Stand by Me,11900000,0,11900000,2021.csv,2021,0.0,1.0
4305,Layer Cake,11850214,2339957,9510257,2004.csv,2004,0.1974611597731484,0.8025388402268516
4306,The Rules of Attraction,11819244,6532619,5286625,2002.csv,2002,0.5527103933212649,0.44728960667873513
4307,Chill Factor,11788676,11263966,524710,1999.csv,1999,0.9554903366586714,0.044509663341328574
4308,On the Line,11772156,0,11772156,2021.csv,2021,0.0,1.0
4309,The Son's Room,11767402,1016340,10751062,2001.csv,2001,0.08636910679179652,0.9136308932082035
4310,Beyond Borders,11705002,4430101,7274901,2003.csv,2003,0.3784793031218619,0.621520696878138
4311,Mohou-han,11702775,0,11702775,2002.csv,2002,0.0,1.0
4312,Wotakoi: Love Is Hard for Otaku,11702371,0,11702371,2020.csv,2020,0.0,1.0
4313,Les rois mages,11702020,0,11702020,2001.csv,2001,0.0,1.0
4314,The Adventures of Elmo in Grouchland,11683047,11683047,0,1999.csv,1999,1.0,0.0
4315,Let Him Go,11630934,9358025,2272909,2020.csv,2020,0.8045806983342868,0.19541930166571317
4316,The Muse,11614954,11614954,0,1999.csv,1999,1.0,0.0
4317,Wing Commander,11578059,11578059,0,1999.csv,1999,1.0,0.0
4318,The Order,11560806,7660806,3900000,2002.csv,2002,0.6626532786727846,0.33734672132721544
4319,The Legend of Drunken Master,11555430,11555430,0,2000.csv,2000,1.0,0.0
4320,Boys Don't Cry,11540607,11540607,0,1999.csv,1999,1.0,0.0
4321,The Hunt,11481750,5812500,5669250,2020.csv,2020,0.5062381605591482,0.4937618394408518
4322,The Experiment,11455141,0,11455141,2001.csv,2001,0.0,1.0
4323,Suspect Zero,11416075,8725813,2690262,2004.csv,2004,0.7643444003302361,0.2356555996697639
4324,Connie and Carla,11341016,8085771,3255245,2004.csv,2004,0.7129670745548723,0.28703292544512765
4325,Kabhi Khushi Kabhie Gham...,11329690,2902000,8427690,2001.csv,2001,0.2561411653805179,0.7438588346194821
4326,The Fable: The Killer Who Doesn't Kill,11325545,0,11325545,2021.csv,2021,0.0,1.0
4327,What Did You Eat Yesterday?,11320893,0,11320893,2021.csv,2021,0.0,1.0
4328,Jug Jugg Jeeyo,11290977,1033000,10257977,2022.csv,2022,0.09148898275144834,0.9085110172485517
4329,The Dope,11289473,0,11289473,2003.csv,2003,0.0,1.0
4330,The Little Polar Bear,11243547,0,11243547,2001.csv,2001,0.0,1.0
4331,You Can Count on Me,11242521,9416804,1825717,2000.csv,2000,0.8376060849697323,0.16239391503026768
4332,Shadow of the Vampire,11155214,8293784,2861430,2000.csv,2000,0.7434894570377583,0.2565105429622417
4333,Aline,11149943,667815,10482128,2021.csv,2021,0.059894028157812106,0.9401059718421879
4334,Naruto the Movie: Ninja Clash in the Land of Snow,11141307,0,11141307,2004.csv,2004,0.0,1.0
4335,Kamen Rider 555: Paradise Lost,11067556,0,11067556,2003.csv,2003,0.0,1.0
4336,Head-On,11030861,435395,10595466,2004.csv,2004,0.039470626998200774,0.9605293730017992
4337,Adrenaline Rush: The Science of Risk,11011932,10994028,17904,2002.csv,2002,0.9983741272648614,0.0016258727351385752
4338,30 jours max,11007713,0,11007713,2020.csv,2020,0.0,1.0
4339,The Voice of Sin,10983063,0,10983063,2020.csv,2020,0.0,1.0
4340,Bigfoot Family,10982184,0,10982184,2020.csv,2020,0.0,1.0
4341,District B13,10976892,1200216,9776676,2004.csv,2004,0.10934023947762263,0.8906597605223774
4342,Extreme Ops,10959475,4842259,6117216,2002.csv,2002,0.441833117006061,0.558166882993939
4343,Cookie's Fortune,10920544,10920544,0,1999.csv,1999,1.0,0.0
4344,The Perfect Score,10898337,10391003,507334,2004.csv,2004,0.9534484940225284,0.04655150597747161
4345,Lucky Numbers,10890222,10042516,847706,2000.csv,2000,0.9221589789445982,0.0778410210554018
4346,Here on Earth,10873148,10522168,350980,2000.csv,2000,0.9677204798463149,0.03227952015368502
4347,The End of the Affair,10827816,10827816,0,1999.csv,1999,1.0,0.0
4348,Office Space,10827810,10827810,0,1999.csv,1999,1.0,0.0
4349,One Second,10791301,0,10791301,2020.csv,2020,0.0,1.0
4350,Me contro Te - Il film: La vendetta del Signor S,10779891,0,10779891,2020.csv,2020,0.0,1.0
4351,Godzilla: Tokyo S.O.S.,10724345,0,10724345,2003.csv,2003,0.0,1.0
4352,Impractical Jokers: The Movie,10691091,10691091,0,2020.csv,2020,1.0,0.0
4353,Universal Soldier: The Return,10667893,10667893,0,1999.csv,1999,1.0,0.0
4354,Island of the Sharks,10658505,10658505,0,1999.csv,1999,1.0,0.0
4355,Honest Candidate,10597464,0,10597464,2020.csv,2020,0.0,1.0
4356,Drop Dead Gorgeous,10571408,10571408,0,1999.csv,1999,1.0,0.0
4357,Three to Tango,10570375,10570375,0,1999.csv,1999,1.0,0.0
4358,Champion,10569737,0,10569737,2002.csv,2002,0.0,1.0
4359,Pollock,10558970,8598593,1960377,2000.csv,2000,0.814340129766445,0.18565987023355499
4360,Two by Two: Overboard!,10543763,0,10543763,2020.csv,2020,0.0,1.0
4361,Inuyasha the Movie: Affections Touching Across Time,10539779,0,10539779,2001.csv,2001,0.0,1.0
4362,Anatomy,10501958,9660,10492298,2000.csv,2000,0.0009198284738902974,0.9990801715261097
4363,The Cooler,10464788,8291572,2173216,2003.csv,2003,0.7923306234201782,0.2076693765798218
4364,Krack,10442916,0,10442916,2021.csv,2021,0.0,1.0
4365,The Virgin Suicides,10409377,4906229,5503148,2000.csv,2000,0.4713278229811448,0.5286721770188552
4366,A Touch of Spice,10395779,0,10395779,2003.csv,2003,0.0,1.0
4367,Town & Country,10372291,6719973,3652318,2001.csv,2001,0.6478774072189066,0.35212259278109337
4368,Wasabi,10366360,97220,10269140,2001.csv,2001,0.009378412480369195,0.9906215875196308
4369,Kaiserschmarrndrama,10357720,0,10357720,2021.csv,2021,0.0,1.0
4370,"Caution, Hazardous Wife: The Movie",10356359,0,10356359,2021.csv,2021,0.0,1.0
4371,Realm of Terracotta,10341512,0,10341512,2021.csv,2021,0.0,1.0
4372,Street Dancer 3D,10339127,0,10339127,2020.csv,2020,0.0,1.0
4373,Bibi Blocksberg,10325928,0,10325928,2002.csv,2002,0.0,1.0
4374,Detective Conan: The Scarlet Alibi,10308627,0,10308627,2021.csv,2021,0.0,1.0
4375,Men,10282342,7587853,2694489,2022.csv,2022,0.7379498756217212,0.2620501243782788
4376,The Pirates: The Last Royal Treasure,10258331,0,10258331,2022.csv,2022,0.0,1.0
4377,The Wash,10229331,10097538,131793,2001.csv,2001,0.9871161662478221,0.012883833752177928
4378,Never Stop,10224935,0,10224935,2021.csv,2021,0.0,1.0
4379,My Spy,10200000,0,10200000,2020.csv,2020,0.0,1.0
4380,Woman on Top,10194274,5020111,5174163,2000.csv,2000,0.492444189748088,0.507555810251912
4381,Bats,10155690,10155690,0,1999.csv,1999,1.0,0.0
4382,Vaillante,10143170,0,10143170,2022.csv,2022,0.0,1.0
4383,Thirteen,10128960,4601043,5527917,2003.csv,2003,0.4542463392095536,0.5457536607904464
4384,Brokedown Palace,10115013,10115013,0,1999.csv,1999,1.0,0.0
4385,Kamen Rider Ryuki: Episode Final,10112538,0,10112538,2002.csv,2002,0.0,1.0
4386,Pulse: A Stomp Odyssey,10086514,10086514,0,2002.csv,2002,1.0,0.0
4387,The Asadas,10066797,0,10066797,2020.csv,2020,0.0,1.0
4388,Beauty and the Beast 2020 Re-release,10055094,467000,9588094,2020.csv,2020,0.046444120761078914,0.953555879238921
4389,Sexy Beast,10045677,6946056,3099621,2001.csv,2001,0.6914472762761534,0.30855272372384657
4390,Girls on Top,10038662,0,10038662,2001.csv,2001,0.0,1.0
4391,Godzilla 2000: Millennium,10037390,10037390,0,2000.csv,2000,1.0,0.0
4392,The Deep End,10031529,8823109,1208420,2001.csv,2001,0.8795378052538152,0.12046219474618475
4393,Kisarazu Cat's Eye: Nihon Series,10029866,0,10029866,2003.csv,2003,0.0,1.0
4394,Elephant,10012022,1266955,8745067,2003.csv,2003,0.12654336956111362,0.8734566304388863
4395,Dudley Do-Right,9974410,9974410,0,1999.csv,1999,1.0,0.0
4396,Whatever It Takes,9902115,8745680,1156435,2000.csv,2000,0.8832133337170898,0.11678666628291026
4397,Shin Chan: The Adult Empire Strikes Back,9851449,0,9851449,2003.csv,2003,0.0,1.0
4398,3 Strikes,9832166,9832166,0,2000.csv,2000,1.0,0.0
4399,Rise,9744486,0,9744486,2022.csv,2022,0.0,1.0
4400,Ainbo,9739890,0,9739890,2021.csv,2021,0.0,1.0
4401,Black Box,9738741,0,9738741,2021.csv,2021,0.0,1.0
4402,Sumikko Gurashi The Movie: The Magical Child Of The Blue Moonlit Night,9735732,0,9735732,2021.csv,2021,0.0,1.0
4403,My Life Without Me,9726954,400948,9326006,2003.csv,2003,0.041220303910144945,0.958779696089855
4404,Bread and Tulips,9719848,5318679,4401169,2000.csv,2000,0.547197754532787,0.4528022454672131
4405,Stolen Identity 2,9687188,0,9687188,2020.csv,2020,0.0,1.0
4406,The Young Black Stallion,9638389,6751389,2887000,2003.csv,2003,0.7004686156576582,0.29953138434234183
4407,The Soul,9600000,0,9600000,2021.csv,2021,0.0,1.0
4408,Married for 7 Years,9545175,0,9545175,2003.csv,2003,0.0,1.0
4409,¡A todo tren! Destino Asturias,9544171,0,9544171,2021.csv,2021,0.0,1.0
4410,Talk to Her Undated France Release,9541068,0,9541068,2022.csv,2022,0.0,1.0
4411,Baragaki: Unbroken Samurai,9481437,0,9481437,2021.csv,2021,0.0,1.0
4412,100% Wolf,9481180,658764,8822416,2020.csv,2020,0.06948122491082334,0.9305187750891767
4413,10 Days with Dad,9472077,2359,9469718,2020.csv,2020,0.000249047806515931,0.9997509521934841
4414,Secret Zoo,9471940,0,9471940,2020.csv,2020,0.0,1.0
4415,Redeeming Love,9464198,9214020,250178,2022.csv,2022,0.9735658531235293,0.026434146876470672
4416,365 Days,9458590,0,9458590,2020.csv,2020,0.0,1.0
4417,Veronica Guerin,9439660,1571504,7868156,2003.csv,2003,0.1664788774171951,0.8335211225828049
4418,Okay Madam,9433525,0,9433525,2020.csv,2020,0.0,1.0
4419,Ghost Dog: The Way of the Samurai,9380473,3308029,6072444,2000.csv,2000,0.3526505539752633,0.6473494460247367
4420,The Flying Classroom,9378807,0,9378807,2003.csv,2003,0.0,1.0
4421,L'appel de la forêt,9317347,0,9317347,2020.csv,2020,0.0,1.0
4422,Mad Love,9306362,280046,9026316,2001.csv,2001,0.030091887678557958,0.969908112321442
4423,Dad,9267397,0,9267397,2021.csv,2021,0.0,1.0
4424,State and Main,9206279,6944471,2261808,2000.csv,2000,0.7543189816428548,0.24568101835714515
4425,The Love Letter,9139145,8302478,836667,1999.csv,1999,0.908452377109675,0.09154762289032507
4426,Inception 10th Anniversary re-release,9100000,0,9100000,2020.csv,2020,0.0,1.0
4427,The Closet,9039424,0,9039424,2020.csv,2020,0.0,1.0
4428,Trippin',9017070,9017070,0,1999.csv,1999,1.0,0.0
4429,Smack Dab Kakha,8992930,0,8992930,2022.csv,2022,0.0,1.0
4430,Malasaña 32,8968845,0,8968845,2020.csv,2020,0.0,1.0
4431,Break the Silence: The Movie,8954345,0,8954345,2020.csv,2020,0.0,1.0
4432,Teaching Mrs. Tingle,8951935,8951935,0,1999.csv,1999,1.0,0.0
4433,"Spring, Summer, Fall, Winter... and Spring",8944914,2380788,6564126,2003.csv,2003,0.26616108327033666,0.7338389167296634
4434,I Hate Summer,8926071,0,8926071,2020.csv,2020,0.0,1.0
4435,Kandahar,8914751,1418314,7496437,2001.csv,2001,0.15909743300738294,0.8409025669926171
4436,All About My Mother,8900000,0,8900000,2021.csv,2021,0.0,1.0
4437,Downhill,8899195,8287061,612134,2020.csv,2020,0.9312146772826081,0.06878532271739185
4438,"Mystery, Alaska",8891623,8891623,0,1999.csv,1999,1.0,0.0
4439,Les blagues de Toto,8859185,0,8859185,2020.csv,2020,0.0,1.0
4440,Après Vous,8852763,830292,8022471,2003.csv,2003,0.09378902383357603,0.906210976166424
4441,The Eleventh Chapter,8845525,0,8845525,2021.csv,2021,0.0,1.0
4442,The Vault,8803864,0,8803864,2021.csv,2021,0.0,1.0
4443,Kaguya-sama: Love Is War,8794981,0,8794981,2021.csv,2021,0.0,1.0
4444,18 Years Later,8785730,25611,8760119,2003.csv,2003,0.0029150679567890203,0.997084932043211
4445,Son of the Bride,8772695,624757,8147938,2001.csv,2001,0.07121608582083384,0.9287839141791662
4446,Ghost World,8764007,6217849,2546158,2001.csv,2001,0.7094755857680168,0.29052441423198316
4447,Le coeur des hommes,8755325,0,8755325,2003.csv,2003,0.0,1.0
4448,The Protégé,8740445,7446823,1293622,2021.csv,2021,0.8519958651990831,0.1480041348009169
4449,Chickenhare and the Hamster of Darkness,8736836,0,8736836,2022.csv,2022,0.0,1.0
4450,The Secret Garden,8721243,0,8721243,2020.csv,2020,0.0,1.0
4451,The Forsaken,8704851,7288451,1416400,2001.csv,2001,0.8372861293088187,0.16271387069118126
4452,Play It to the Bone,8678812,8434146,244666,1999.csv,1999,0.9718088143861164,0.02819118561388356
4453,Tini: The New Life of Violetta,8678476,0,8678476,2001.csv,2001,0.0,1.0
4454,The Medium,8643812,0,8643812,2021.csv,2021,0.0,1.0
4455,Eltilerin Savasi,8613864,0,8613864,2020.csv,2020,0.0,1.0
4456,The Prince and the Pirate,8579972,0,8579972,2001.csv,2001,0.0,1.0
4457,Agent Backkom: Kings Bear,8578734,0,8578734,2021.csv,2021,0.0,1.0
4458,Lost Illusions,8570572,96646,8473926,2021.csv,2021,0.011276493564256855,0.9887235064357431
4459,Samrat Prithviraj,8568339,0,8568339,2022.csv,2022,0.0,1.0
4460,Before Night Falls,8527517,4242892,4284625,2000.csv,2000,0.49755303917893096,0.502446960821069
4461,Honey Lemon Soda,8441488,0,8441488,2021.csv,2021,0.0,1.0
4462,Pushing Tin,8408835,8408835,0,1999.csv,1999,1.0,0.0
4463,Malang,8399765,0,8399765,2020.csv,2020,0.0,1.0
4464,Bones,8378853,7316658,1062195,2001.csv,2001,0.8732290684655764,0.12677093153442362
4465,The Lord of the Rings: The Fellowship of the Ring 2021 Re-release,8377569,0,8377569,2021.csv,2021,0.0,1.0
4466,Twin Dragons,8359717,8359717,0,1999.csv,1999,1.0,0.0
4467,Delicious,8299095,0,8299095,2021.csv,2021,0.0,1.0
4468,Don,8287406,0,8287406,2022.csv,2022,0.0,1.0
4469,Merry Christmas,8228560,0,8228560,2001.csv,2001,0.0,1.0
4470,I Don't Have Any Money Left in My Retirement Account,8204616,0,8204616,2021.csv,2021,0.0,1.0
4471,White Snake 2: Green Snake,8170000,0,8170000,2021.csv,2021,0.0,1.0
4472,Finnick,8125942,0,8125942,2022.csv,2022,0.0,1.0
4473,New Happy Dad and Son 4,8070000,0,8070000,2021.csv,2021,0.0,1.0
4474,Acharya,8048175,832000,7216175,2022.csv,2022,0.1033774737751105,0.8966225262248895
4475,Your Eyes Tell,8020474,0,8020474,2020.csv,2020,0.0,1.0
4476,AI Amok,7932191,0,7932191,2020.csv,2020,0.0,1.0
4477,Silver Skates,7891319,0,7891319,2021.csv,2021,0.0,1.0
4478,Sunny Sisters,7880000,0,7880000,2021.csv,2021,0.0,1.0
4479,The Lost Prince,7837980,0,7837980,2020.csv,2020,0.0,1.0
4480,Dziewczyny z Dubaju,7837628,0,7837628,2021.csv,2021,0.0,1.0
4481,"My Donkey, My Lover & I",7821615,0,7821615,2020.csv,2020,0.0,1.0
4482,Antebellum,7792716,0,7792716,2020.csv,2020,0.0,1.0
4483,The Marriage Escape,7760946,0,7760946,2020.csv,2020,0.0,1.0
4484,Butterfly,7733894,2092682,5641212,2000.csv,2000,0.27058581356299943,0.7294141864370005
4485,Spirited Away Studio Ghibli Fest 2020,7732435,0,7732435,2020.csv,2020,0.0,1.0
4486,Chempion mira,7718753,0,7718753,2022.csv,2022,0.0,1.0
4487,Princess Mononoke Studio Ghibli Fest 2020,7673207,0,7673207,2020.csv,2020,0.0,1.0
4488,The Hole,7644361,0,7644361,2001.csv,2001,0.0,1.0
4489,Sex and Lucía,7640680,1594779,6045901,2001.csv,2001,0.2087221294439762,0.7912778705560238
4490,Hard Hit,7633895,0,7633895,2021.csv,2021,0.0,1.0
4491,The Heist of the Century,7627100,0,7627100,2020.csv,2020,0.0,1.0
4492,Ants in the Pants,7625967,0,7625967,2000.csv,2000,0.0,1.0
4493,Monkeybone,7622365,5411999,2210366,2001.csv,2001,0.7100157234664044,0.28998427653359554
4494,Sunshine,7607860,5096267,2511593,1999.csv,1999,0.6698686621467798,0.33013133785322024
4495,Little Canned Men,7600000,0,7600000,2021.csv,2021,0.0,1.0
4496,Pushpa: The Rise - Part 1,7592374,1320000,6272374,2021.csv,2021,0.1738586639699256,0.8261413360300743
4497,The Mauritanian,7527030,836536,6690494,2021.csv,2021,0.11113759344655195,0.8888624065534481
4498,777 Charlie,7523995,0,7523995,2022.csv,2022,0.0,1.0
4499,The Ice Road,7502846,0,7502846,2021.csv,2021,0.0,1.0
4500,De Gaulle,7501454,0,7501454,2020.csv,2020,0.0,1.0
4501,Fukushima 50,7494243,0,7494243,2020.csv,2020,0.0,1.0
4502,Judas and the Black Messiah,7428769,5478009,1950760,2021.csv,2021,0.7374046763333199,0.26259532366668015
4503,Love Letter 2021 Re-release,7400000,0,7400000,2021.csv,2021,0.0,1.0
4504,Requiem for a Dream,7390108,3635482,3754626,2000.csv,2000,0.49193895407211913,0.5080610459278809
4505,Signal: The Movie,7388603,0,7388603,2021.csv,2021,0.0,1.0
4506,Bachchhan Paandey,7387882,0,7387882,2022.csv,2022,0.0,1.0
4507,The Best Years,7354042,0,7354042,2020.csv,2020,0.0,1.0
4508,'83,7351061,4055660,3295401,2021.csv,2021,0.5517108346672678,0.4482891653327322
4509,Lesson in Murder,7348964,0,7348964,2022.csv,2022,0.0,1.0
4510,Mean Machine,7310206,92770,7217436,2001.csv,2001,0.012690476848395244,0.9873095231516048
4511,Outside Providence,7302522,7302522,0,1999.csv,1999,1.0,0.0
4512,Osomatsusan the Movie 2022 Re-release,7297522,0,7297522,2022.csv,2022,0.0,1.0
4513,Run Lola Run,7267585,7267585,0,1999.csv,1999,1.0,0.0
4514,Where the Money Is,7243669,5661798,1581871,2000.csv,2000,0.7816201982724501,0.21837980172754995
4515,Contra,7216863,0,7216863,2021.csv,2021,0.0,1.0
4516,Mamma Mia! Here We Go Again 2020 Re-release,7209678,0,7209678,2020.csv,2020,0.0,1.0
4517,Screwed,7201701,7027345,174356,2000.csv,2000,0.9757896085938585,0.02421039140614141
4518,Dear Tutu: Operation T-Rex,7200000,0,7200000,2021.csv,2021,0.0,1.0
4519,Widow of St. Pierre,7193889,3193889,4000000,2000.csv,2000,0.44397251611749916,0.5560274838825008
4520,The (UN)perfect Guy,7154649,0,7154649,2020.csv,2020,0.0,1.0
4521,Bohemian Rhapsody 2020 Re-release,7154052,240000,6914052,2020.csv,2020,0.03354742179676636,0.9664525782032336
4522,Back to the Wharf,7090000,0,7090000,2020.csv,2020,0.0,1.0
4523,Adu,7085946,0,7085946,2020.csv,2020,0.0,1.0
4524,Croupier,7075068,6201143,873925,2000.csv,2000,0.8764782190079304,0.12352178099206962
4525,Fatale,7031289,6306897,724392,2020.csv,2020,0.896975931440167,0.10302406855983305
4526,Mobile Suit Gundam: Cucuruz Doan's Island,6998742,0,6998742,2022.csv,2022,0.0,1.0
4527,Spycies,6989285,0,6989285,2020.csv,2020,0.0,1.0
4528,Jim Button and the Wild 13,6942395,0,6942395,2020.csv,2020,0.0,1.0
4529,Dragon Rider,6907050,0,6907050,2020.csv,2020,0.0,1.0
4530,The Slurb,6854681,0,6854681,2001.csv,2001,0.0,1.0
4531,200 Cigarettes,6852450,6852450,0,1999.csv,1999,1.0,0.0
4532,China: The Panda Adventure,6784985,3921642,2863343,2001.csv,2001,0.5779883080065763,0.4220116919934237
4533,The Road Home,6780490,1280490,5500000,2001.csv,2001,0.1888491834660917,0.8111508165339083
4534,The Piano Teacher,6749315,1012069,5737246,2001.csv,2001,0.14995136543486265,0.8500486345651374
4535,Psy 3: W imie zasad,6725146,0,6725146,2020.csv,2020,0.0,1.0
4536,Blood Moon Party,6709383,0,6709383,2020.csv,2020,0.0,1.0
4537,Rabbit Academy,6690002,0,6690002,2022.csv,2022,0.0,1.0
4538,Innocence,6659968,0,6659968,2020.csv,2020,0.0,1.0
4539,Duets,6620242,4739023,1881219,2000.csv,2000,0.7158383334023137,0.2841616665976863
4540,Shubh Mangal Zyada Saavdhan,6574905,0,6574905,2020.csv,2020,0.0,1.0
4541,Lost & Found,6552255,6552255,0,1999.csv,1999,1.0,0.0
4542,Chhapaak,6532100,604334,5927766,2020.csv,2020,0.09251756709174691,0.907482432908253
4543,Under the Sand,6531687,1452698,5078989,2001.csv,2001,0.22240777918476498,0.777592220815235
4544,"Love Me, Love Me Not",6494241,0,6494241,2020.csv,2020,0.0,1.0
4545,The Devil's Backbone,6459020,755249,5703771,2001.csv,2001,0.11692934841508464,0.8830706515849154
4546,Hammamet,6434874,0,6434874,2020.csv,2020,0.0,1.0
4547,The Straight Story,6416325,6203044,213281,1999.csv,1999,0.9667596326557648,0.03324036734423521
4548,Lindenberg! Mach dein Ding,6404964,0,6404964,2020.csv,2020,0.0,1.0
4549,Midnight Swan,6397065,0,6397065,2020.csv,2020,0.0,1.0
4550,Nausicaä of the Valley of the Wind 2020 Re-release,6395525,0,6395525,2020.csv,2020,0.0,1.0
4551,Cyrano,6390409,3873124,2517285,2022.csv,2022,0.6060838985423311,0.3939161014576688
4552,Adieu Monsieur Haffmann,6349658,0,6349658,2022.csv,2022,0.0,1.0
4553,Simply Black,6323750,0,6323750,2020.csv,2020,0.0,1.0
4554,My Boyfriend's Meds,6292780,2971116,3321664,2020.csv,2020,0.47214680951820975,0.5278531904817902
4555,Bill & Ted Face the Music,6274027,3439660,2834367,2020.csv,2020,0.5482379977006793,0.4517620022993207
4556,Dick,6262878,6262878,0,1999.csv,1999,1.0,0.0
4557,Topsy-Turvy,6208548,6208548,0,1999.csv,1999,1.0,0.0
4558,Hotel Belgrade,6199413,0,6199413,2020.csv,2020,0.0,1.0
4559,Kingmaker,6049522,0,6049522,2022.csv,2022,0.0,1.0
4560,Megiddo: The Omega Code 2,6047691,6047691,0,2001.csv,2001,1.0,0.0
4561,Chaos,6042938,0,6042938,2001.csv,2001,0.0,1.0
4562,Foolish,6033999,6033999,0,1999.csv,1999,1.0,0.0
4563,How to Be a Good Wife,6029102,0,6029102,2020.csv,2020,0.0,1.0
4564,Notre Dame on Fire,6027925,0,6027925,2022.csv,2022,0.0,1.0
4565,The Legacy Of Dr. Death: Black File,6024046,0,6024046,2020.csv,2020,0.0,1.0
4566,Now or Never,5995963,0,5995963,2000.csv,2000,0.0,1.0
4567,The Rhythm Section,5989583,5437971,551612,2020.csv,2020,0.9079047740051353,0.09209522599486475
4568,Light It Up,5985690,5985690,0,1999.csv,1999,1.0,0.0
4569,Jak zostalem gangsterem. Historia prawdziwa,5975729,0,5975729,2020.csv,2020,0.0,1.0
4570,The Lion King 2020 Re-release,5948352,0,5948352,2020.csv,2020,0.0,1.0
4571,Twiceborn,5880157,11527,5868630,2020.csv,2020,0.001960321807734045,0.9980396781922659
4572,The Policeman's Lineage,5869939,0,5869939,2022.csv,2022,0.0,1.0
4573,Tom Thumb,5867304,0,5867304,2001.csv,2001,0.0,1.0
4574,The Royal Bride,5830719,0,5830719,2020.csv,2020,0.0,1.0
4575,Beasts Clawing at Straws,5796059,0,5796059,2020.csv,2020,0.0,1.0
4576,Radiation House,5793450,0,5793450,2022.csv,2022,0.0,1.0
4577,Bheeshma Parvam,5779651,0,5779651,2022.csv,2022,0.0,1.0
4578,Goliath,5770632,0,5770632,2022.csv,2022,0.0,1.0
4579,The Golden Bowl,5753678,3050532,2703146,2001.csv,2001,0.5301881683333687,0.4698118316666313
4580,Last Letter,5663972,0,5663972,2020.csv,2020,0.0,1.0
4581,Yowamushi Pedal: The Movie 2020 Re-release,5624218,0,5624218,2020.csv,2020,0.0,1.0
4582,Hocus Pocus 2020 Re-release,5609193,4828000,781193,2020.csv,2020,0.8607298768289842,0.13927012317101586
4583,A Fish Tale,5595327,563911,5031416,2001.csv,2001,0.10078249224754872,0.8992175077524512
4584,Artek: Bolshoe puteshestvie,5580855,0,5580855,2022.csv,2022,0.0,1.0
4585,Klassikokkutulek 2: Pulmad ja matused,5543147,0,5543147,2020.csv,2020,0.0,1.0
4586,Black & White,5541431,5277299,264132,2000.csv,2000,0.9523350556922932,0.0476649443077068
4587,Made,5480653,5313300,167353,2001.csv,2001,0.9694647699827009,0.030535230017299034
4588,Mama Weed,5432038,29151,5402887,2020.csv,2020,0.005366494122463797,0.9946335058775362
4589,A Piece of Cake,5408238,0,5408238,2020.csv,2020,0.0,1.0
4590,Read My Lips,5393526,1471911,3921615,2001.csv,2001,0.2729032918354338,0.7270967081645662
4591,The Exorcism of God,5333869,0,5333869,2022.csv,2022,0.0,1.0
4592,Charlotte Gray,5323109,741394,4581715,2001.csv,2001,0.139278380360049,0.860721619639951
4593,Divorce Club,5316313,0,5316313,2020.csv,2020,0.0,1.0
4594,The in Crowd,5280035,5280035,0,2000.csv,2000,1.0,0.0
4595,Cats & Dogs 3: Paws Unite,5270750,0,5270750,2020.csv,2020,0.0,1.0
4596,The Wandering Moon,5262479,0,5262479,2022.csv,2022,0.0,1.0
4597,Les Segpa,5238208,0,5238208,2022.csv,2022,0.0,1.0
4598,Siegfried & Roy: The Magic Box,5231283,5231283,0,1999.csv,1999,1.0,0.0
4599,Cindy La Regia,5222322,0,5222322,2020.csv,2020,0.0,1.0
4600,Run,5184368,0,5184368,2020.csv,2020,0.0,1.0
4601,The House of Mirth,5164404,3043284,2121120,2000.csv,2000,0.5892807766394729,0.4107192233605272
4602,The Cherry Bushido,5122729,17586,5105143,2022.csv,2022,0.0034329358433756695,0.9965670641566243
4603,Love Aaj Kal,5120794,0,5120794,2020.csv,2020,0.0,1.0
4604,Masked Ward,5107013,0,5107013,2020.csv,2020,0.0,1.0
4605,Ayyappanum Koshiyum,5088713,0,5088713,2020.csv,2020,0.0,1.0
4606,Baba Parasi,5084342,0,5084342,2020.csv,2020,0.0,1.0
4607,Die Känguru-Chroniken,5081127,0,5081127,2020.csv,2020,0.0,1.0
4608,Otto - Der Katastrofenfilm,5058355,0,5058355,2000.csv,2000,0.0,1.0
4609,The Real Exorcist,5035830,0,5035830,2020.csv,2020,0.0,1.0
4610,Mayday,5011408,0,5011408,2020.csv,2020,0.0,1.0
4611,Bheeshma,4997080,0,4997080,2020.csv,2020,0.0,1.0
4612,Made in Abyss: Dawn of the Deep Soul,4971635,0,4971635,2020.csv,2020,0.0,1.0
4613,Major,4961424,0,4961424,2022.csv,2022,0.0,1.0
4614,Jakob the Liar,4956401,4956401,0,1999.csv,1999,1.0,0.0
4615,Godai - The Wunderkind,4948225,0,4948225,2020.csv,2020,0.0,1.0
4616,Maigret,4944938,0,4944938,2022.csv,2022,0.0,1.0
4617,Decision to Leave,4902248,0,4902248,2022.csv,2022,0.0,1.0
4618,Military Wives,4890505,0,4890505,2020.csv,2020,0.0,1.0
4619,Panga,4886124,582720,4303404,2020.csv,2020,0.11926017432222351,0.8807398256777765
4620,The Tales for Old and Young,4853143,0,4853143,2020.csv,2020,0.0,1.0
4621,Streltsov,4850073,0,4850073,2020.csv,2020,0.0,1.0
4622,Wolves,4811282,4811282,0,1999.csv,1999,1.0,0.0
4623,The SpongeBob Movie: Sponge on the Run,4810790,4810790,0,2020.csv,2020,1.0,0.0
4624,The Empty Man,4796993,2992948,1804045,2020.csv,2020,0.6239216942780613,0.37607830572193873
4625,The Vets,4788826,0,4788826,2020.csv,2020,0.0,1.0
4626,The Broken Hearts Gallery,4781389,4067442,713947,2020.csv,2020,0.8506820925885763,0.14931790741142376
4627,Gladiator 20th Anniversary,4780585,0,4780585,2020.csv,2020,0.0,1.0
4628,Mansfield Park,4775847,4775847,0,1999.csv,1999,1.0,0.0
4629,Whipped,4775009,4159986,615023,2000.csv,2000,0.8711996144928732,0.1288003855071268
4630,Intruder,4751103,0,4751103,2020.csv,2020,0.0,1.0
4631,A Walk on the Moon,4750660,4750660,0,1999.csv,1999,1.0,0.0
4632,Held Up,4705631,4705631,0,2000.csv,2000,1.0,0.0
4633,Y cómo es él?,4625869,1500636,3125233,2022.csv,2022,0.324400885541722,0.675599114458278
4634,The Cursed,4588389,4588389,0,2022.csv,2022,1.0,0.0
4635,Mumford,4555459,4555459,0,1999.csv,1999,1.0,0.0
4636,Waiting for Bojangles,4538023,0,4538023,2022.csv,2022,0.0,1.0
4637,Sweet and Lowdown,4525794,4197015,328779,1999.csv,1999,0.9273544045531016,0.07264559544689837
4638,Flawless,4488529,4488529,0,1999.csv,1999,1.0,0.0
4639,Kaathu Vaakula Rendu Kadhal,4474859,0,4474859,2022.csv,2022,0.0,1.0
4640,The Jungle Book 2000 Re-release,4466472,0,4466472,2000.csv,2000,0.0,1.0
4641,The Tao of Steve,4406030,4342203,63827,2000.csv,2000,0.9855137164295296,0.014486283570470469
4642,Simply Irresistible,4398989,4398989,0,1999.csv,1999,1.0,0.0
4643,Vysehrad: Fylm,4317319,0,4317319,2022.csv,2022,0.0,1.0
4644,Permis de construire,4298296,0,4298296,2022.csv,2022,0.0,1.0
4645,Mohabbatein,4279351,1070000,3209351,2000.csv,2000,0.25003791462770875,0.7499620853722913
4646,Pawankhind,4260686,0,4260686,2022.csv,2022,0.0,1.0
4647,Detroit Rock City,4217115,4217115,0,1999.csv,1999,1.0,0.0
4648,The Godfather 2022 Re-release,4214662,1414662,2800000,2022.csv,2022,0.33565253868518996,0.66434746131481
4649,Gloria,4197729,4197729,0,1999.csv,1999,1.0,0.0
4650,Free! The Final Stroke Part 2,4197237,0,4197237,2022.csv,2022,0.0,1.0
4651,East Is East,4177818,4177818,0,2000.csv,2000,1.0,0.0
4652,Idle Hands,4152230,4152230,0,1999.csv,1999,1.0,0.0
4653,Em Va Trinh,4141438,0,4141438,2022.csv,2022,0.0,1.0
4654,Irréductible,4095019,0,4095019,2022.csv,2022,0.0,1.0
4655,Le Dîner de Cons,4071548,4071548,0,1999.csv,1999,1.0,0.0
4656,Bossa Nova,4069261,1823297,2245964,2000.csv,2000,0.4480658773177734,0.5519341226822265
4657,Runway 34,4062826,0,4062826,2022.csv,2022,0.0,1.0
4658,Erkan & Stefan,4026949,0,4026949,2000.csv,2000,0.0,1.0
4659,Playing by Heart,3970078,3970078,0,1999.csv,1999,1.0,0.0
4660,In Our Prime,3969245,0,3969245,2022.csv,2022,0.0,1.0
4661,Family Camp,3958122,3958122,0,2022.csv,2022,1.0,0.0
4662,The Winslow Boy,3957934,3957934,0,1999.csv,1999,1.0,0.0
4663,Koniec swiata czyli Kogel Mogel 4,3957350,0,3957350,2022.csv,2022,0.0,1.0
4664,The Outfit,3946743,3344040,602703,2022.csv,2022,0.847291044793137,0.15270895520686298
4665,Beautiful Minds,3923125,0,3923125,2022.csv,2022,0.0,1.0
4666,Pettson & Findus - Katten och gubbens år,3920489,0,3920489,2000.csv,2000,0.0,1.0
4667,Fireheart,3892632,14221,3878411,2022.csv,2022,0.003653312206239891,0.9963466877937601
4668,Desperate for Marriage,3878443,0,3878443,2022.csv,2022,0.0,1.0
4669,Saunkan Saunkne,3822831,0,3822831,2022.csv,2022,0.0,1.0
4670,Un Autre Monde,3766165,0,3766165,2022.csv,2022,0.0,1.0
4671,"Lock, Stock and Two Smoking Barrels",3753929,3753929,0,1999.csv,1999,1.0,0.0
4672,The One 2022 Re-release,3744292,0,3744292,2022.csv,2022,0.0,1.0
4673,Up at the Villa,3740113,2933161,806952,2000.csv,2000,0.7842439519875469,0.2157560480124531
4674,Liberty Heights,3736868,3736868,0,1999.csv,1999,1.0,0.0
4675,The Big Kahuna,3728888,3165544,563344,2000.csv,2000,0.8489243978365668,0.1510756021634332
4676,King,3710203,0,3710203,2022.csv,2022,0.0,1.0
4677,Between Two Worlds,3652168,0,3652168,2022.csv,2022,0.0,1.0
4678,Naked Truth,3628553,0,3628553,2022.csv,2022,0.0,1.0
4679,Disobedient,3601801,0,3601801,2022.csv,2022,0.0,1.0
4680,Special Delivery,3581156,0,3581156,2022.csv,2022,0.0,1.0
4681,Price of Glory,3548556,3440228,108328,2000.csv,2000,0.9694726531017124,0.030527346898287643
4682,Official Competition,3536417,453912,3082505,2022.csv,2022,0.1283536415530182,0.8716463584469818
4683,Belli ciao,3423873,0,3423873,2022.csv,2022,0.0,1.0
4684,Crimes of the Future,3406485,2452882,953603,2022.csv,2022,0.7200624690847017,0.2799375309152983
4685,Last Seen Alive,3383753,0,3383753,2022.csv,2022,0.0,1.0
4686,Fifty,3328240,3328240,0,1999.csv,1999,1.0,0.0
4687,Elvis Gratton II: Miracle à Memphis,3316272,3316272,0,1999.csv,1999,1.0,0.0
4688,Train of Life,3311162,98687,3212475,1999.csv,1999,0.029804340591007023,0.970195659408993
4689,The Way Of The Househusband,3285070,0,3285070,2022.csv,2022,0.0,1.0
4690,Gangubai Kathiawadi,3271210,592000,2679210,2022.csv,2022,0.1809727898850884,0.8190272101149116
4691,Etharkkum Thunindhavan,3266724,0,3266724,2022.csv,2022,0.0,1.0
4692,Ox-Head Village,3250402,0,3250402,2022.csv,2022,0.0,1.0
4693,Heropanti 2,3235970,0,3235970,2022.csv,2022,0.0,1.0
4694,Gun Shy,3221280,1638202,1583078,2000.csv,2000,0.5085562260964586,0.49144377390354144
4695,The Limey,3204663,3204663,0,1999.csv,1999,1.0,0.0
4696,The Phantom of the Open,3185425,658891,2526534,2022.csv,2022,0.20684555436087806,0.793154445639122
4697,Beautiful,3169930,3157348,12582,2000.csv,2000,0.996030827179149,0.003969172820850933
4698,Jana Gana Mana,3135150,0,3135150,2022.csv,2022,0.0,1.0
4699,Jawbreaker,3117085,3117085,0,1999.csv,1999,1.0,0.0
4700,La brigade,3112109,0,3112109,2022.csv,2022,0.0,1.0
4701,Ante Sundharaniki,3097334,620000,2477334,2022.csv,2022,0.2001721480473207,0.7998278519526794
4702,Heart of Oak,3068589,0,3068589,2022.csv,2022,0.0,1.0
4703,I Want To Know Your Parents,3056992,0,3056992,2022.csv,2022,0.0,1.0
4704,Le temps des secrets,3047202,0,3047202,2022.csv,2022,0.0,1.0
4705,The Young Lovers,3036351,0,3036351,2022.csv,2022,0.0,1.0
4706,The Grandmother,3029310,0,3029310,2022.csv,2022,0.0,1.0
4707,Studio 666,3018515,2513963,504552,2022.csv,2022,0.832847608840771,0.16715239115922895
4708,Isn't She Great,3003296,2962465,40831,2000.csv,2000,0.9864046034756481,0.013595396524351912
4709,Extremely Easy Job,2956808,0,2956808,2022.csv,2022,0.0,1.0
4710,The Glance of Music,2946540,0,2946540,2022.csv,2022,0.0,1.0
4711,Love Stinks,2924635,2924635,0,1999.csv,1999,1.0,0.0
4712,Cradle Will Rock,2903404,2903404,0,1999.csv,1999,1.0,0.0
4713,Hot Blooded,2901023,0,2901023,2022.csv,2022,0.0,1.0
4714,XxxHolic,2882403,0,2882403,2022.csv,2022,0.0,1.0
4715,No More School,2870533,0,2870533,2000.csv,2000,0.0,1.0
4716,eXistenZ,2856712,2856712,0,1999.csv,1999,1.0,0.0
4717,Chia Khoa Tram Ty,2851565,0,2851565,2022.csv,2022,0.0,1.0
4718,Koschey. The Bride Kidnapper,2839471,0,2839471,2022.csv,2022,0.0,1.0
4719,What to Do with the Dead Kaiju?,2827966,0,2827966,2022.csv,2022,0.0,1.0
4720,Seventeen Power of Love,2823989,0,2823989,2022.csv,2022,0.0,1.0
4721,Eingeschlossene Gesellschaft,2773478,0,2773478,2022.csv,2022,0.0,1.0
4722,Flickering Lights,2760019,0,2760019,2000.csv,2000,0.0,1.0
4723,Costa!!,2738958,0,2738958,2022.csv,2022,0.0,1.0
4724,The Color of Paradise,2724595,1817216,907379,2000.csv,2000,0.6669673841433313,0.3330326158566686
4725,¡Qué Despadre!,2681505,0,2681505,2022.csv,2022,0.0,1.0
4726,God's Army,2637726,2637726,0,2000.csv,2000,1.0,0.0
4727,The Wannabes,2627605,0,2627605,2022.csv,2022,0.0,1.0
4728,Ténor,2623936,0,2623936,2022.csv,2022,0.0,1.0
4729,Laid-Back Camp Movie,2598979,0,2598979,2022.csv,2022,0.0,1.0
4730,But I'm a Cheerleader,2595216,2205627,389589,2000.csv,2000,0.849881859544639,0.15011814045536095
4731,Vietnamese Horror Story,2569119,0,2569119,2022.csv,2022,0.0,1.0
4732,Promises,2560866,0,2560866,2022.csv,2022,0.0,1.0
4733,Cherry Magic! Thirty Years Of Virginity Can Make You A Wizard?!: The Movie,2493914,0,2493914,2022.csv,2022,0.0,1.0
4734,Corro da te,2479312,0,2479312,2022.csv,2022,0.0,1.0
4735,Bamboozled,2463650,2274979,188671,2000.csv,2000,0.9234180991618127,0.07658190083818724
4736,Mission «Sky»,2457275,0,2457275,2022.csv,2022,0.0,1.0
4737,Tonbi,2442782,0,2442782,2022.csv,2022,0.0,1.0
4738,The Hound of the Baskervilles,2381508,0,2381508,2022.csv,2022,0.0,1.0
4739,Tri kota i more priklyucheniy,2380495,0,2380495,2022.csv,2022,0.0,1.0
4740,The Red Herring,2336496,0,2336496,2022.csv,2022,0.0,1.0
4741,Dreaming of the Meridian Arc,2324739,0,2324739,2022.csv,2022,0.0,1.0
4742,East/West,2321029,2321029,0,2000.csv,2000,1.0,0.0
4743,Ensemble Stars!! Road to Show!!,2287844,0,2287844,2022.csv,2022,0.0,1.0
4744,Dharmaveer,2285089,0,2285089,2022.csv,2022,0.0,1.0
4745,Krylya nad Berlinom,2276024,0,2276024,2022.csv,2022,0.0,1.0
4746,Alcarràs,2272164,0,2272164,2022.csv,2022,0.0,1.0
4747,Teasing Master Takagi-san: The Movie,2262412,0,2262412,2022.csv,2022,0.0,1.0
4748,The Young Man 2022 Re-release,2244212,0,2244212,2022.csv,2022,0.0,1.0
4749,Umma,2232593,2121025,111568,2022.csv,2022,0.9500276136313247,0.04997238636867535
4750,Tajemství staré bambitky 2,2223380,0,2223380,2022.csv,2022,0.0,1.0
4751,Autumn Tale,2215467,2205339,10128,1999.csv,1999,0.9954285033358655,0.004571496664134469
4752,The Beatles: Get Back - The Rooftop Concert,2209986,976712,1233274,2022.csv,2022,0.44195393092987917,0.5580460690701208
4753,The Pass: Last Days of the Samurai,2180846,0,2180846,2022.csv,2022,0.0,1.0
4754,The Nan Movie,2167020,0,2167020,2022.csv,2022,0.0,1.0
4755,A Dog of Flanders,2165637,2165637,0,1999.csv,1999,1.0,0.0
4756,Around the World in 80 Days,2164782,0,2164782,2022.csv,2022,0.0,1.0
4757,Limbo,2160710,2160710,0,1999.csv,1999,1.0,0.0
4758,Raavan,2158734,0,2158734,2022.csv,2022,0.0,1.0
4759,Jersey,2156815,0,2156815,2022.csv,2022,0.0,1.0
4760,Shower,2150929,1157764,993165,2000.csv,2000,0.5382623043345457,0.4617376956654543
4761,Odinnadtsat molchalivykh muzhchin,2126741,0,2126741,2022.csv,2022,0.0,1.0
4762,The Contractor,2122288,1035265,1087023,2022.csv,2022,0.4878060847538129,0.5121939152461872
4763,Left Luggage,2111280,1069540,1041740,2000.csv,2000,0.5065836838316092,0.4934163161683907
4764,Trick,2087228,2087228,0,1999.csv,1999,1.0,0.0
4765,Incredible But True,2084861,0,2084861,2022.csv,2022,0.0,1.0
4766,Hurdang,2081549,0,2081549,2022.csv,2022,0.0,1.0
4767,Moy papa - vozhd,2074688,0,2074688,2022.csv,2022,0.0,1.0
4768,Blood Simple 2000 Re-release,2068701,1701855,366846,2000.csv,2000,0.82266842815854,0.17733157184145992
4769,Ravenous,2062405,2062405,0,1999.csv,1999,1.0,0.0
4770,Marlene,2061924,0,2061924,2000.csv,2000,0.0,1.0
4771,Beyond the Mat,2053648,2053648,0,1999.csv,1999,1.0,0.0
4772,Besieged,2048740,2048740,0,1999.csv,1999,1.0,0.0
4773,Hamlet,2046433,1577287,469146,2000.csv,2000,0.7707493966330684,0.22925060336693162
4774,Final Cut,2045734,0,2045734,2022.csv,2022,0.0,1.0
4775,Wildfire: Feel the Heat,2040635,2040635,0,1999.csv,1999,1.0,0.0
4776,Three Seasons,2021698,2021698,0,1999.csv,1999,1.0,0.0
4777,Taal,2020532,2020532,0,1999.csv,1999,1.0,0.0
4778,The Broken Hearts Club: A Romantic Comedy,2019121,1746585,272536,2000.csv,2000,0.8650224528396268,0.13497754716037325
4779,Better Than Chocolate,2015406,2015406,0,1999.csv,1999,1.0,0.0
4780,Titus,2007290,2007290,0,1999.csv,1999,1.0,0.0
4781,Crazy in Alabama,2005840,2005840,0,1999.csv,1999,1.0,0.0
4782,Hum Saath-Saath Hain,2005094,2005094,0,1999.csv,1999,1.0,0.0
4783,La traversée,1981256,0,1981256,2022.csv,2022,0.0,1.0
4784,Cecil B. Demented,1961544,1284646,676898,2000.csv,2000,0.6549157194536549,0.3450842805463451
4785,The Beatles: Get Back,1959336,0,1959336,2022.csv,2022,0.0,1.0
4786,Watcher,1957479,1957479,0,2022.csv,2022,1.0,0.0
4787,"Happy, Texas",1955933,1955933,0,1999.csv,1999,1.0,0.0
4788,Goodbye Lover,1940299,1940299,0,1999.csv,1999,1.0,0.0
4789,Champagne!,1938987,0,1938987,2022.csv,2022,0.0,1.0
4790,Mia and Me,1924656,0,1924656,2022.csv,2022,0.0,1.0
4791,Jayeshbhai Jordaar,1924567,0,1924567,2022.csv,2022,0.0,1.0
4792,Mia and Me: The Hero of Centopia,1918059,0,1918059,2022.csv,2022,0.0,1.0
4793,Wedding High,1908598,0,1908598,2022.csv,2022,0.0,1.0
4794,Tango,1897948,1897948,0,1999.csv,1999,1.0,0.0
4795,Holy Smoke,1765545,1765545,0,1999.csv,1999,1.0,0.0
4796,The Dreamlife of Angels,1726567,1726567,0,1999.csv,1999,1.0,0.0
4797,The Life and Times of Hank Greenberg,1712385,1712385,0,2000.csv,2000,1.0,0.0
4798,The Girl on the Bridge,1708839,1708839,0,2000.csv,2000,1.0,0.0
4799,Romance,1585642,1585642,0,1999.csv,1999,1.0,0.0
4800,Asterix and Obelix vs. Caesar,1541261,1541261,0,1999.csv,1999,1.0,0.0
